GEOID,NAME.x,estimate_2010,pop_2010,NAME.y,estimate_2019,pop_2019,PLACEA,pop_1990,estimate_1990,dif_10_19,dif_90_19,change_perc_10_19,change_perc_90_19,share_2010,share_2019,share_1990,share_dif_10_19,share_dif_90_19
0604982,"Bellflower city, California",9669,75944,"Bellflower city, California",10289,77195,04982,61793,3874,620,6415,0.0641224532009515,1.6559112028910687,0.12731749710312862,0.13328583457477816,0.0626931853122522,0.005968337471649543,0.07059264926252597
0604996,"Bell Gardens city, California",368,42408,"Bell Gardens city, California",493,42421,04996,42355,223,125,270,0.33967391304347827,1.210762331838565,0.008677607998490851,0.011621602508191697,0.00526502183921615,0.002943994509700846,0.006356580668975547
0605108,"Belmont city, California",574,25281,"Belmont city, California",307,27097,05108,24195,384,-267,-77,-0.4651567944250871,-0.20052083333333334,0.02270479806969661,0.011329667490866148,0.015871047737135772,-0.011375130578830463,-0.004541380246269624
0605164,"Belvedere city, California",8,2116,"Belvedere city, California",0,2134,05164,2147,0,-8,0,-1,NA,0.003780718336483932,0,0,-0.003780718336483932,0
0605262,"Benbow CDP, California",0,569,"Benbow CDP, California",0,118,05262,161,0,0,0,NA,NA,0,0,0,0,0
0605276,"Bend CDP, California",0,575,"Bend CDP, California",0,498,05276,565,4,0,-4,NA,-1,0,0,0.007079646017699115,0,-0.007079646017699115
0605290,"Benicia city, California",1132,26959,"Benicia city, California",941,28192,05290,24437,1300,-191,-359,-0.1687279151943463,-0.27615384615384614,0.041989688044808786,0.033378263337116916,0.0531980193968163,-0.00861142470769187,-0.019819756059699385
0605332,"Ben Lomond CDP, California",13,6102,"Ben Lomond CDP, California",23,6890,05332,6597,53,10,-30,0.7692307692307693,-0.5660377358490566,0.0021304490331039002,0.0033381712626995644,0.008033954827952099,0.0012077222295956641,-0.004695783565252534
0605346,"Benton CDP, California",0,289,"Benton CDP, California",0,328,05346,228,0,0,0,NA,NA,0,0,0,0,0
0606000,"Berkeley city, California",10769,109408,"Berkeley city, California",9594,121485,06000,102724,19281,-1175,-9687,-0.10910948091744824,-0.5024117006379337,0.09842973091547236,0.07897271268057784,0.18769713017405865,-0.019457018234894513,-0.1087244174934808
0606028,"Bermuda Dunes CDP, California",230,6879,"Bermuda Dunes CDP, California",131,6704,06028,4416,51,-99,80,-0.43043478260869567,1.5686274509803921,0.03343509230992877,0.019540572792362768,0.01154891304347826,-0.013894519517566001,0.007991659748884508
0606070,"Berry Creek CDP, California",0,1209,"Berry Creek CDP, California",0,1313,06070,1209,3,0,-3,NA,-1,0,0,0.0024813895781637717,0,-0.0024813895781637717
0606150,"Bertsch-Oceanview CDP, California",0,2589,"Bertsch-Oceanview CDP, California",0,1988,06150,1581,10,0,-10,NA,-1,0,0,0.006325110689437065,0,-0.006325110689437065
0606210,"Bethel Island CDP, California",23,2191,"Bethel Island CDP, California",100,2161,06210,2115,21,77,79,3.347826086956522,3.761904761904762,0.010497489730716568,0.04627487274409996,0.009929078014184398,0.03577738301338339,0.03634579472991556
0606308,"Beverly Hills city, California",928,33980,"Beverly Hills city, California",665,34186,06308,31995,543,-263,122,-0.2834051724137931,0.22467771639042358,0.027310182460270747,0.019452407418241384,0.016971401781528363,-0.0078577750420293635,0.0024810056367130205
0606336,"Bieber CDP, California",0,257,"Bieber CDP, California",0,156,06336,456,0,0,0,NA,NA,0,0,0,0,0
0606406,"Big Bear City CDP, California",140,11937,"Big Bear City CDP, California",161,13463,06406,8517,16,21,145,0.15,9.0625,0.011728239926279634,0.011958701626680533,0.0018785957496771164,2.3046170040089825e-4,0.010080105877003417
0606434,"Big Bear Lake city, California",35,5171,"Big Bear Lake city, California",16,5241,06434,5358,20,-19,-4,-0.5428571428571428,-0.2,0.006768516727905628,0.0030528525090631558,0.003732736095558044,-0.003715664218842472,-6.798835864948883e-4
0606475,"Big Bend CDP, California",0,91,"Big Bend CDP, California",3,132,06475,166,0,3,3,NA,NA,0,0.022727272727272728,0,0.022727272727272728,0.022727272727272728
0606518,"Big Creek CDP, California",0,189,"Big Creek CDP, California",0,198,06518,288,0,0,0,NA,NA,0,0,0,0,0
0606560,"Biggs city, California",12,2077,"Biggs city, California",0,2175,06560,1602,0,-12,0,-1,NA,0.005777563793933558,0,0,-0.005777563793933558,0
0606567,"Big Lagoon CDP, California",0,189,"Big Lagoon CDP, California",0,100,06567,41,0,0,0,NA,NA,0,0,0,0,0
0606616,"Big Pine CDP, California",13,1682,"Big Pine CDP, California",14,1524,06616,1610,0,1,14,0.07692307692307693,NA,0.0077288941736028535,0.009186351706036745,0,0.0014574575324338918,0.009186351706036745
0606635,"Big River CDP, California",31,1212,"Big River CDP, California",7,1149,06635,705,22,-24,-15,-0.7741935483870968,-0.6818181818181818,0.02557755775577558,0.006092254134029591,0.031205673758865248,-0.019485303621745987,-0.025113419624835657
0606728,"Biola CDP, California",0,997,"Biola CDP, California",52,1705,06728,1051,3,52,49,NA,16.333333333333332,0,0.030498533724340176,0.0028544243577545195,0.030498533724340176,0.027644109366585658
0606798,"Bishop city, California",0,3826,"Bishop city, California",41,3745,06798,3475,8,41,33,NA,4.125,0,0.010947930574098798,0.002302158273381295,0.010947930574098798,0.008645772300717502
0606928,"Blackhawk CDP, California",347,9607,"Blackhawk CDP, California",161,9604,06928,6416,93,-186,68,-0.5360230547550432,0.7311827956989247,0.036119496200686996,0.016763848396501458,0.01449501246882793,-0.019355647804185538,0.0022688359276735286
0606935,"Blacklake CDP, California",0,1195,"Blacklake CDP, California",0,850,06935,367,0,0,0,NA,NA,0,0,0,0,0
0606982,"Black Point-Green Point CDP, California",0,1284,"Black Point-Green Point CDP, California",0,1622,06982,1178,2,0,-2,NA,-1,0,0,0.001697792869269949,0,-0.001697792869269949
0606994,"Blairsden CDP, California",0,33,"Blairsden CDP, California",0,18,06994,78,0,0,0,NA,NA,0,0,0,0,0
0607036,"Bloomfield CDP, California",0,336,"Bloomfield CDP, California",0,292,07036,916,20,0,-20,NA,-1,0,0,0.021834061135371178,0,-0.021834061135371178
0607064,"Bloomington CDP, California",749,24982,"Bloomington CDP, California",576,21847,07064,15635,452,-173,124,-0.23097463284379172,0.2743362831858407,0.029981586742454568,0.026365175996704352,0.028909497921330348,-0.0036164107457502155,-0.002544321924625996
0607162,"Blue Lake city, California",29,1293,"Blue Lake city, California",0,902,07162,1235,1,-29,-1,-1,-1,0.02242846094354215,0,8.097165991902834e-4,-0.02242846094354215,-8.097165991902834e-4
0607172,"Bluewater CDP, California",0,175,"Bluewater CDP, California",0,163,07172,261,0,0,0,NA,NA,0,0,0,0,0
0607218,"Blythe city, California",3446,21164,"Blythe city, California",2208,19643,07218,11247,996,-1238,1212,-0.359257109692397,1.216867469879518,0.1628236628236628,0.11240645522578017,0.08855694851960523,-0.05041720759788264,0.023849506706174944
0607246,"Bodega CDP, California",0,207,"Bodega CDP, California",19,892,07246,201,0,19,19,NA,NA,0,0.021300448430493273,0,0.021300448430493273,0.021300448430493273
0607260,"Bodega Bay CDP, California",0,784,"Bodega Bay CDP, California",0,665,07260,1131,0,0,0,NA,NA,0,0,0,0,0
0607274,"Bodfish CDP, California",0,1942,"Bodfish CDP, California",0,2030,07274,1766,6,0,-6,NA,-1,0,0,0.0033975084937712344,0,-0.0033975084937712344
0607316,"Bolinas CDP, California",0,1162,"Bolinas CDP, California",0,1074,07316,1361,22,0,-22,NA,-1,0,0,0.016164584864070537,0,-0.016164584864070537
0607372,"Bombay Beach CDP, California",138,300,"Bombay Beach CDP, California",6,297,07372,354,59,-132,-53,-0.9565217391304348,-0.8983050847457628,0.46,0.020202020202020204,0.16666666666666666,-0.4397979797979798,-0.14646464646464646
0607379,"Bonadelle Ranchos-Madera Ranchos CDP, California",581,8940,"Bonadelle Ranchos-Madera Ranchos CDP, California",102,9551,07379,5883,82,-479,20,-0.8244406196213425,0.24390243902439024,0.06498881431767338,0.01067950999895299,0.013938466768655448,-0.054309304318720386,-0.0032589567697024584
0607414,"Bonita CDP, California",734,14065,"Bonita CDP, California",319,12706,07414,12566,342,-415,-23,-0.5653950953678474,-0.06725146198830409,0.05218627799502311,0.025106249016212813,0.027216297946840683,-0.027080028978810296,-0.0021100489306278697
0607470,"Bonny Doon CDP, California",48,2410,"Bonny Doon CDP, California",34,3096,07470,2426,7,-14,27,-0.2916666666666667,3.857142857142857,0.01991701244813278,0.010981912144702842,0.0028854080791426216,-0.008935100303429937,0.00809650406556022
0607498,"Bonsall CDP, California",132,4235,"Bonsall CDP, California",52,4458,07498,3046,19,-80,33,-0.6060606060606061,1.736842105263158,0.03116883116883117,0.011664423508299685,0.00623768877216021,-0.019504407660531485,0.005426734736139476
0607512,"Boonville CDP, California",0,1048,"Boonville CDP, California",56,947,07512,917,15,56,41,NA,2.7333333333333334,0,0.059134107708553325,0.016357688113413305,0.059134107708553325,0.04277641959514002
0607525,"Bootjack CDP, California",0,918,"Bootjack CDP, California",0,743,07525,430,0,0,0,NA,NA,0,0,0,0,0
0607568,"Boron CDP, California",104,2075,"Boron CDP, California",84,2221,07568,2903,43,-20,41,-0.19230769230769232,0.9534883720930233,0.05012048192771084,0.03782080144079244,0.014812263176024801,-0.012299680486918402,0.023008538264767637
0607578,"Boronda CDP, California",62,1778,"Boronda CDP, California",13,1763,07578,1227,20,-49,-7,-0.7903225806451613,-0.35,0.03487064116985377,0.00737379466817924,0.016299918500407497,-0.02749684650167453,-0.008926123832228256
0607596,"Borrego Springs CDP, California",0,2412,"Borrego Springs CDP, California",112,2145,07596,2244,0,112,112,NA,NA,0,0.052214452214452214,0,0.052214452214452214,0.052214452214452214
0607624,"Bostonia CDP, California",931,14515,"Bostonia CDP, California",1518,16603,07624,13615,371,587,1147,0.6305048335123523,3.091644204851752,0.06414054426455391,0.0914292597723303,0.02724935732647815,0.02728871550777638,0.06417990244585214
0607652,"Boulder Creek CDP, California",0,5386,"Boulder Creek CDP, California",44,5182,07652,5907,28,44,16,NA,0.5714285714285714,0,0.008490930142802007,0.004740138818351109,0.008490930142802007,0.0037507913244508983
0607694,"Boulevard CDP, California",0,31,"Boulevard CDP, California",0,405,07694,182,0,0,0,NA,NA,0,0,0,0,0
0607750,"Bowles CDP, California",8,183,"Bowles CDP, California",0,272,07750,197,2,-8,-2,-1,-1,0.04371584699453552,0,0.01015228426395939,-0.04371584699453552,-0.01015228426395939
0607848,"Boyes Hot Springs CDP, California",31,6965,"Boyes Hot Springs CDP, California",133,7728,07848,5272,24,102,109,3.2903225806451615,4.541666666666667,0.004450825556353195,0.017210144927536232,0.004552352048558422,0.012759319371183037,0.01265779287897781
0607946,"Bradbury city, California",6,978,"Bradbury city, California",8,833,07946,778,18,2,-10,0.3333333333333333,-0.5555555555555556,0.006134969325153374,0.009603841536614645,0.02313624678663239,0.003468872211461271,-0.013532405250017745
0607974,"Bradley CDP, California",0,80,"Bradley CDP, California",0,113,07974,79,0,0,0,NA,NA,0,0,0,0,0
0608058,"Brawley city, California",964,24288,"Brawley city, California",372,26076,08058,18993,470,-592,-98,-0.6141078838174274,-0.20851063829787234,0.03969038208168643,0.014265991716520939,0.024745959037540146,-0.025424390365165493,-0.010479967321019207
0608100,"Brea city, California",453,38427,"Brea city, California",770,42678,08100,33173,357,317,413,0.6997792494481236,1.1568627450980393,0.011788586150363026,0.018042082571816862,0.010761764085250054,0.006253496421453836,0.007280318486566809
0608142,"Brentwood city, California",2731,46283,"Brentwood city, California",5342,61961,08142,9220,54,2611,5288,0.9560600512632735,97.92592592592592,0.05900654668020656,0.08621552266748439,0.005856832971800434,0.027208975987277832,0.08035868969568395
0608172,"Bret Harte CDP, California",89,5102,"Bret Harte CDP, California",8,5148,08172,4106,11,-81,-3,-0.9101123595505618,-0.2727272727272727,0.017444139553116425,0.001554001554001554,0.002679006332196785,-0.015890137999114873,-0.001125004778195231
0608240,"Bridgeport CDP, California",0,402,"Bridgeport CDP, California",4,542,08240,666,2,4,2,NA,1,0,0.007380073800738007,0.003003003003003003,0.007380073800738007,0.004377070797735004
0608310,"Brisbane city, California",39,4098,"Brisbane city, California",131,4697,08310,2952,52,92,79,2.358974358974359,1.5192307692307692,0.00951683748169839,0.027890142644241004,0.017615176151761516,0.018373305162542614,0.010274966492479488
0608338,"Broadmoor CDP, California",21,3917,"Broadmoor CDP, California",62,5170,08338,3741,86,41,-24,1.9523809523809523,-0.27906976744186046,0.005361245851416901,0.011992263056092843,0.022988505747126436,0.006631017204675942,-0.010996242691033593
0608478,"Brookdale CDP, California",0,1827,"Brookdale CDP, California",24,1939,08478,1757,22,24,2,NA,0.09090909090909091,0,0.012377514182568335,0.012521343198634035,0.012377514182568335,-1.4382901606570068e-4
0608530,"Brooktrails CDP, California",0,3495,"Brooktrails CDP, California",0,3800,08530,2216,13,0,-13,NA,-1,0,0,0.0058664259927797835,0,-0.0058664259927797835
0608680,"Buckhorn CDP, California",0,2712,"Buckhorn CDP, California",10,2387,08680,2354,16,10,-6,NA,-0.375,0,0.0041893590280687055,0.006796941376380629,0.0041893590280687055,-0.0026075823483119234
0608716,"Buck Meadows CDP, California",0,0,"Buck Meadows CDP, California",0,10,08716,70,0,0,0,NA,NA,NA,0,0,NA,0
0608744,"Bucks Lake CDP, California",0,23,"Bucks Lake CDP, California",0,0,08744,19,0,0,0,NA,NA,0,NA,0,NA,NA
0608758,"Buellton city, California",0,4609,"Buellton city, California",44,5082,08758,3455,11,44,33,NA,3,0,0.008658008658008658,0.0031837916063675834,0.008658008658008658,0.005474217051641075
0608786,"Buena Park city, California",3374,79744,"Buena Park city, California",2376,82489,08786,68858,1755,-998,621,-0.2957913455838767,0.35384615384615387,0.04231039325842697,0.028803840512068277,0.025487234598739434,-0.013506552746358692,0.0033166059133288434
0608828,"Buena Vista CDP, California",0,518,"Buena Vista CDP, California",10,595,08828,377,0,10,10,NA,NA,0,0.01680672268907563,0,0.01680672268907563,0.01680672268907563
0608954,"Burbank city, California",2104,102723,"Burbank city, California",3139,103703,08954,93643,1638,1035,1501,0.4919201520912547,0.9163614163614163,0.02048226784653875,0.03026913396912336,0.017491964161763292,0.00978686612258461,0.012777169807360069
0608968,"Burbank CDP, California",55,4927,"Burbank CDP, California",43,5022,08968,4551,126,-12,-83,-0.21818181818181817,-0.6587301587301587,0.01116297950071037,0.008562325766626843,0.027686222808174028,-0.002600653734083528,-0.019123897041547183
0609066,"Burlingame city, California",467,28204,"Burlingame city, California",367,30576,09066,26801,261,-100,106,-0.21413276231263384,0.4061302681992337,0.016557935044674513,0.012002878074306646,0.009738442595425544,-0.004555056970367868,0.002264435478881102
0609122,"Burney CDP, California",0,3091,"Burney CDP, California",51,3965,09122,3423,5,51,46,NA,9.2,0,0.012862547288776798,0.001460706982179375,0.012862547288776798,0.011401840306597423
0609150,"Burnt Ranch CDP, California",0,232,"Burnt Ranch CDP, California",0,299,09150,259,0,0,0,NA,NA,0,0,0,0,0
0609310,"Butte Creek Canyon CDP, California",0,1016,"Butte Creek Canyon CDP, California",0,958,09310,958,1,0,-1,NA,-1,0,0,0.0010438413361169101,0,-0.0010438413361169101
0609318,"Butte Meadows CDP, California",0,30,"Butte Meadows CDP, California",0,41,09318,41,0,0,0,NA,NA,0,0,0,0,0
0609324,"Butte Valley CDP, California",0,948,"Butte Valley CDP, California",0,736,09324,647,4,0,-4,NA,-1,0,0,0.0061823802163833074,0,-0.0061823802163833074
0609332,"Buttonwillow CDP, California",139,1675,"Buttonwillow CDP, California",12,1443,09332,1337,164,-127,-152,-0.9136690647482014,-0.926829268292683,0.08298507462686568,0.008316008316008316,0.12266267763649963,-0.07466906631085736,-0.11434666932049131
0609346,"Byron CDP, California",59,1200,"Byron CDP, California",52,1304,09346,1117,45,-7,7,-0.11864406779661017,0.15555555555555556,0.049166666666666664,0.03987730061349693,0.04028648164726947,-0.009289366053169733,-4.0918103377254184e-4
0609353,"Bystrom CDP, California",0,4010,"Bystrom CDP, California",3,3759,09353,3301,62,3,-59,NA,-0.9516129032258065,0,7.980845969672786e-4,0.018782187215995155,7.980845969672786e-4,-0.017984102619027876
0609360,"Cabazon CDP, California",100,1931,"Cabazon CDP, California",77,2588,09360,1678,81,-23,-4,-0.23,-0.04938271604938271,0.05178663904712584,0.029752704791344668,0.048271752085816445,-0.022033934255781172,-0.018519047294471777
0609598,"Calabasas city, California",590,22686,"Calabasas city, California",384,23988,09598,15823,171,-206,213,-0.34915254237288135,1.2456140350877194,0.026007229128096623,0.016008004002001,0.010807053024078873,-0.009999225126095624,0.005200950977922126
0609710,"Calexico city, California",77,36304,"Calexico city, California",125,39946,09710,19176,42,48,83,0.6233766233766234,1.9761904761904763,0.002120978404583517,0.0031292244530115657,0.002190237797246558,0.0010082460484280489,9.389866557650076e-4
0609780,"California City city, California",1826,13264,"California City city, California",3603,13826,09780,5921,682,1777,2921,0.9731653888280394,4.282991202346041,0.1376658624849216,0.2605959785910603,0.11518324607329843,0.12293011610613871,0.14541273251776188
0609822,"California Hot Springs CDP, California",0,65,"California Hot Springs CDP, California",0,47,09822,38,0,0,0,NA,NA,0,0,0,0,0
0609834,"California Pines CDP, California",0,126,"California Pines CDP, California",0,431,09834,410,2,0,-2,NA,-1,0,0,0.004878048780487805,0,-0.004878048780487805
0609864,"Calimesa city, California",47,7869,"Calimesa city, California",111,8814,09864,6700,15,64,96,1.3617021276595744,6.4,0.005972804676578981,0.01259360108917631,0.002238805970149254,0.006620796412597329,0.010354795119027056
0609878,"Calipatria city, California",19,6953,"Calipatria city, California",1161,7395,09878,2701,89,1142,1072,60.10526315789474,12.044943820224718,0.0027326333956565513,0.1569979716024341,0.03295075897815624,0.15426533820677754,0.12404721262427784
0609892,"Calistoga city, California",36,5147,"Calistoga city, California",0,5271,09892,4468,12,-36,-12,-1,-1,0.006994365649893142,0,0.0026857654431512983,-0.006994365649893142,-0.0026857654431512983
0609948,"Callender CDP, California",0,1436,"Callender CDP, California",0,1215,09948,922,6,0,-6,NA,-1,0,0,0.006507592190889371,0,-0.006507592190889371
0609990,"Calpella CDP, California",52,791,"Calpella CDP, California",0,682,09990,850,13,-52,-13,-1,-1,0.06573957016434892,0,0.015294117647058824,-0.06573957016434892,-0.015294117647058824
0610004,"Calpine CDP, California",0,122,"Calpine CDP, California",0,182,10004,187,0,0,0,NA,NA,0,0,0,0,0
0610031,"Calwa CDP, California",0,1627,"Calwa CDP, California",155,2089,10031,1894,31,155,124,NA,4,0,0.07419818094782192,0.016367476240760296,0.07419818094782192,0.05783070470706163
0610042,"Camanche North Shore CDP, California",0,777,"Camanche North Shore CDP, California",0,1139,10042,396,12,0,-12,NA,-1,0,0,0.030303030303030304,0,-0.030303030303030304
0610044,"Camanche Village CDP, California",0,589,"Camanche Village CDP, California",0,903,10044,174,2,0,-2,NA,-1,0,0,0.011494252873563218,0,-0.011494252873563218
0610046,"Camarillo city, California",1188,63599,"Camarillo city, California",1318,68122,10046,53125,847,130,471,0.10942760942760943,0.5560802833530106,0.01867953898646205,0.019347640997034732,0.015943529411764707,6.681020105726819e-4,0.0034041115852700247
0610074,"Cambria CDP, California",0,6371,"Cambria CDP, California",33,5647,10074,5385,12,33,21,NA,1.75,0,0.0058438108730299275,0.0022284122562674096,0.0058438108730299275,0.003615398616762518
0610088,"Cambrian Park CDP, California",7,3245,"Cambrian Park CDP, California",13,3258,10088,3060,14,6,-1,0.8571428571428571,-0.07142857142857142,0.0021571648690292757,0.003990178023327195,0.004575163398692811,0.0018330131542979191,-5.849853753656159e-4
0610256,"Cameron Park CDP, California",120,17211,"Cameron Park CDP, California",176,19171,10256,12843,44,56,132,0.4666666666666667,3,0.006972285166463308,0.009180533096865057,0.003425990812115549,0.0022082479304017487,0.005754542284749508
0610270,"Camino CDP, California",0,1732,"Camino CDP, California",0,1903,10270,1458,0,0,0,NA,NA,0,0,0,0,0
0610301,"Camino Tassajara CDP, California",33,1725,"Camino Tassajara CDP, California",76,4721,NA,NA,NA,43,NA,1.303030303030303,NA,0.019130434782608695,0.01609828426180894,NA,-0.003032150520799755,NA
0610345,"Campbell city, California",707,38692,"Campbell city, California",1039,42221,10345,36920,714,332,325,0.4695898161244696,0.45518207282913165,0.018272511113408458,0.024608607091257905,0.01933911159263272,0.006336095977849447,0.005269495498625185
0610494,"Camp Nelson CDP, California",0,66,"Camp Nelson CDP, California",0,0,10494,110,0,0,0,NA,NA,0,NA,0,NA,NA
0610508,"Campo CDP, California",257,2960,"Campo CDP, California",46,3408,10508,2087,63,-211,-17,-0.8210116731517509,-0.2698412698412698,0.08682432432432433,0.013497652582159625,0.03018687110685194,-0.0733266717421647,-0.016689218524692316
0610559,"Camp Pendleton North CDP, California",1062,10104,"Camp Pendleton North CDP, California",299,7367,10559,10373,1896,-763,-1597,-0.7184557438794726,-0.8422995780590717,0.10510688836104513,0.04058639880548391,0.1827822230791478,-0.06452048955556122,-0.1421958242736639
0610561,"Camp Pendleton South CDP, California",1800,13402,"Camp Pendleton South CDP, California",940,11936,10561,11299,2569,-860,-1629,-0.4777777777777778,-0.6340988711560919,0.13430831219221012,0.07875335120643431,0.22736525356226214,-0.05555496098577581,-0.14861190235582783
0610676,"Camptonville CDP, California",0,188,"Camptonville CDP, California",0,339,10676,182,1,0,-1,NA,-1,0,0,0.005494505494505495,0,-0.005494505494505495
0610732,"Canby CDP, California",0,199,"Canby CDP, California",6,282,10732,309,3,6,3,NA,1,0,0.02127659574468085,0.009708737864077669,0.02127659574468085,0.011567857880603181
0610816,"Cantua Creek CDP, California",0,190,"Cantua Creek CDP, California",0,379,10816,537,0,0,0,NA,NA,0,0,0,0,0
0610914,"Canyondam CDP, California",0,0,"Canyondam CDP, California",0,0,10914,48,0,0,0,NA,NA,NA,NA,0,NA,NA
0610928,"Canyon Lake city, California",45,10618,"Canyon Lake city, California",0,11170,10928,10399,95,-45,-95,-1,-1,0.004238086268600489,0,0.009135493797480528,-0.004238086268600489,-0.009135493797480528
0611040,"Capitola city, California",109,9801,"Capitola city, California",58,10121,11040,9990,148,-51,-90,-0.46788990825688076,-0.6081081081081081,0.011121314151617183,0.0057306590257879654,0.014814814814814815,-0.005390655125829217,-0.00908415578902685
0611166,"Caribou CDP, California",0,0,"Caribou CDP, California",0,0,11166,11,0,0,0,NA,NA,NA,NA,0,NA,NA
0611194,"Carlsbad city, California",776,99753,"Carlsbad city, California",1030,114253,11194,63311,745,254,285,0.327319587628866,0.3825503355704698,0.007779214660210721,0.00901508056681225,0.011767307418931939,0.0012358659066015291,-0.002752226852119689
0611250,"Carmel-by-the-Sea city, California",52,3725,"Carmel-by-the-Sea city, California",2,3830,11250,4239,13,-50,-11,-0.9615384615384616,-0.8461538461538461,0.01395973154362416,5.221932114882506e-4,0.003066761028544468,-0.01343753833213591,-0.002544567817056217
0611324,"Carmel Valley Village CDP, California",0,4671,"Carmel Valley Village CDP, California",20,4152,11324,4407,14,20,6,NA,0.42857142857142855,0,0.004816955684007707,0.0031767642387111415,0.004816955684007707,0.0016401914452965653
0611376,"Carmet CDP, California",0,31,"Carmet CDP, California",0,0,11376,56,0,0,0,NA,NA,0,NA,0,NA,NA
0611390,"Carmichael CDP, California",2618,61806,"Carmichael CDP, California",2777,64454,11390,60954,1320,159,1457,0.06073338426279603,1.1037878787878788,0.04235834708604343,0.043084990846184876,0.021655674771138892,7.266437601414488e-4,0.021429316075045984
0611418,"Carnelian Bay CDP, California",0,291,"Carnelian Bay CDP, California",16,451,11418,616,1,16,15,NA,15,0,0.03547671840354767,0.0016233766233766235,0.03547671840354767,0.03385334178017105
0611446,"Carpinteria city, California",34,13122,"Carpinteria city, California",63,13505,11446,13747,105,29,-42,0.8529411764705882,-0.4,0.002591068434689834,0.004664938911514254,0.007638030115661599,0.0020738704768244205,-0.0029730912041473446
0611481,"Carrick CDP, California",0,170,"Carrick CDP, California",0,92,11481,43,3,0,-3,NA,-1,0,0,0.06976744186046512,0,-0.06976744186046512
0611530,"Carson city, California",21422,91299,"Carson city, California",21922,92079,11530,83995,21953,500,-31,0.023340491083932408,-0.0014121076845989159,0.23463564770698475,0.23807817200447443,0.26136079528543366,0.003442524297489674,-0.02328262328095923
0611600,"Cartago CDP, California",0,54,"Cartago CDP, California",0,5,11600,112,0,0,0,NA,NA,0,0,0,0,0
0611614,"Caruthers CDP, California",98,2883,"Caruthers CDP, California",0,2559,11614,1603,5,-98,-5,-1,-1,0.03399236906000694,0,0.0031191515907673115,-0.03399236906000694,-0.0031191515907673115
0611656,"Casa Conejo CDP, California",171,3123,"Casa Conejo CDP, California",61,3372,11656,3286,26,-110,35,-0.6432748538011696,1.3461538461538463,0.05475504322766571,0.018090154211150653,0.007912355447352405,-0.03666488901651506,0.010177798763798249
0611691,"Casa de Oro-Mount Helix CDP, California",1407,19118,"Casa de Oro-Mount Helix CDP, California",1273,19804,11691,19419,539,-134,734,-0.09523809523809523,1.3617810760667903,0.0735955643895805,0.06427994344576853,0.02775632112879139,-0.00931562094381197,0.03652362231697713
0611754,"Casmalia CDP, California",0,400,"Casmalia CDP, California",10,144,11754,120,1,10,9,NA,9,0,0.06944444444444445,0.008333333333333333,0.06944444444444445,0.061111111111111116
0611768,"Caspar CDP, California",0,828,"Caspar CDP, California",0,608,11768,563,5,0,-5,NA,-1,0,0,0.008880994671403197,0,-0.008880994671403197
0611782,"Cassel CDP, California",0,458,"Cassel CDP, California",0,247,11782,163,0,0,0,NA,NA,0,0,0,0,0
0611796,"Castaic CDP, California",1052,18134,"Castaic CDP, California",735,19400,11796,8532,156,-317,579,-0.30133079847908745,3.7115384615384617,0.058012573067166645,0.03788659793814433,0.01828410689170183,-0.020125975129022318,0.0196024910464425
0611915,"Castle Hill CDP, California",0,1328,"Castle Hill CDP, California",83,1426,11915,1126,9,83,74,NA,8.222222222222221,0,0.05820476858345021,0.007992895204262877,0.05820476858345021,0.05021187337918733
0611964,"Castro Valley CDP, California",3765,60625,"Castro Valley CDP, California",5155,63013,11964,50639,1893,1390,3262,0.3691899070385126,1.7231907025884838,0.062103092783505155,0.08180851570310889,0.03738225478386224,0.019705422919603734,0.044426260919246646
0611978,"Castroville CDP, California",0,5490,"Castroville CDP, California",1,6521,11978,5272,86,1,-85,NA,-0.9883720930232558,0,1.5335071308081582e-4,0.016312594840667678,1.5335071308081582e-4,-0.01615924412758686
0612048,"Cathedral City city, California",784,50597,"Cathedral City city, California",1482,54357,12048,30098,667,698,815,0.8903061224489796,1.221889055472264,0.01549498982153092,0.027264197803410783,0.022160940926307396,0.011769207981879862,0.005103256877103387
0612062,"Catheys Valley CDP, California",0,993,"Catheys Valley CDP, California",0,604,12062,649,0,0,0,NA,NA,0,0,0,0,0
0612132,"Cayucos CDP, California",0,2859,"Cayucos CDP, California",0,2630,12132,2875,10,0,-10,NA,-1,0,0,0.0034782608695652175,0,-0.0034782608695652175
0612146,"Cazadero CDP, California",0,362,"Cazadero CDP, California",0,340,12146,661,26,0,-26,NA,-1,0,0,0.039334341906202726,0,-0.039334341906202726
0612300,"Cedar Ridge CDP, California",1,1087,"Cedar Ridge CDP, California",0,1015,12300,952,1,-1,-1,-1,-1,9.199632014719411e-4,0,0.0010504201680672268,-9.199632014719411e-4,-0.0010504201680672268
0612314,"Cedar Slope CDP, California",0,0,"Cedar Slope CDP, California",0,0,12314,11,0,0,0,NA,NA,NA,NA,0,NA,NA
0612328,"Cedarville CDP, California",0,502,"Cedarville CDP, California",0,606,12328,565,0,0,0,NA,NA,0,0,0,0,0
0612412,"Centerville CDP, California",0,307,"Centerville CDP, California",0,379,12412,423,0,0,0,NA,NA,0,0,0,0,0
0612524,"Ceres city, California",1274,44153,"Ceres city, California",1903,48214,12524,27164,455,629,1448,0.4937205651491366,3.182417582417582,0.028854211491857858,0.03946986352511719,0.016750110440288617,0.010615652033259329,0.02271975308482857
0612552,"Cerritos city, California",3454,49432,"Cerritos city, California",4334,50143,12552,53257,3960,880,374,0.25477707006369427,0.09444444444444444,0.06987376598155041,0.08643280218574875,0.07435642262988904,0.016559036204198338,0.012076379555859718
0612594,"Chalfant CDP, California",0,780,"Chalfant CDP, California",0,1005,12594,605,0,0,0,NA,NA,0,0,0,0,0
0612612,"Challenge-Brownsville CDP, California",57,1321,"Challenge-Brownsville CDP, California",8,719,12612,1096,15,-49,-7,-0.8596491228070176,-0.4666666666666667,0.04314912944738834,0.011126564673157162,0.013686131386861315,-0.03202256477423118,-0.0025595667137041523
0612669,"Channel Islands Beach CDP, California",0,3235,"Channel Islands Beach CDP, California",13,2904,12669,3290,34,13,-21,NA,-0.6176470588235294,0,0.004476584022038568,0.01033434650455927,0.004476584022038568,-0.005857762482520703
0612734,"Charter Oak CDP, California",136,9298,"Charter Oak CDP, California",414,10048,12734,9116,386,278,28,2.0441176470588234,0.07253886010362694,0.014626801462680146,0.041202229299363055,0.04234313295304958,0.02657542783668291,-0.0011409036536865272
0612818,"Cherokee CDP, California",0,56,"Cherokee CDP, California",0,137,12818,2,0,0,0,NA,NA,0,0,0,0,0
0612860,"Cherokee Strip CDP, California",0,222,"Cherokee Strip CDP, California",0,214,12860,197,1,0,-1,NA,-1,0,0,0.005076142131979695,0,-0.005076142131979695
0612902,"Cherryland CDP, California",1215,13326,"Cherryland CDP, California",2067,16066,12902,11088,653,852,1414,0.7012345679012346,2.1653905053598774,0.09117514633048177,0.1286567907382049,0.05889249639249639,0.03748164440772314,0.06976429434570852
0612916,"Cherry Valley CDP, California",29,6115,"Cherry Valley CDP, California",315,8115,12916,5632,25,286,290,9.862068965517242,11.6,0.004742436631234669,0.038817005545286505,0.004438920454545455,0.034074568914051834,0.03437808509074105
0612930,"Chester CDP, California",0,1841,"Chester CDP, California",0,2145,12930,2082,4,0,-4,NA,-1,0,0,0.0019212295869356388,0,-0.0019212295869356388
0613014,"Chico city, California",1562,85130,"Chico city, California",1978,94529,13014,64825,1057,416,921,0.26632522407170295,0.8713339640491958,0.018348408316692117,0.020924795565382053,0.016305437716930198,0.002576387248689936,0.004619357848451855
0613077,"Chilcoot-Vinton CDP, California",0,607,"Chilcoot-Vinton CDP, California",0,422,13077,359,0,0,0,NA,NA,0,0,0,0,0
0613157,"China Lake Acres CDP, California",0,1553,"China Lake Acres CDP, California",778,2136,13157,2129,32,778,746,NA,23.3125,0,0.3642322097378277,0.015030530765617662,0.3642322097378277,0.34920167897221005
0613182,"Chinese Camp CDP, California",0,128,"Chinese Camp CDP, California",0,174,13182,122,0,0,0,NA,NA,0,0,0,0,0
0613210,"Chino city, California",5213,77729,"Chino city, California",4928,89631,13210,63404,6791,-285,-1863,-0.05467101477076539,-0.2743336769253424,0.06706634589406785,0.05498097756356618,0.10710680714150526,-0.012085368330501667,-0.052125829577939084
0613214,"Chino Hills city, California",3215,74410,"Chino Hills city, California",3006,80701,13214,37871,1719,-209,1287,-0.06500777604976672,0.7486910994764397,0.04320655825829862,0.03724860906308472,0.04539093237569644,-0.005957949195213898,-0.008142323312611721
0613294,"Chowchilla city, California",2004,18090,"Chowchilla city, California",1519,18413,13294,6150,41,-485,1478,-0.24201596806387227,36.048780487804876,0.11077943615257048,0.08249606256449248,0.006666666666666667,-0.028283373588078004,0.07582939589782581
0613364,"Chualar CDP, California",0,1337,"Chualar CDP, California",0,1512,13364,700,1,0,-1,NA,-1,0,0,0.0014285714285714286,0,-0.0014285714285714286
0613392,"Chula Vista city, California",10931,229614,"Chula Vista city, California",12623,268920,13392,135305,6216,1692,6407,0.15478913182691428,1.0307271557271558,0.047605982213628086,0.046939610293023945,0.0459406525996822,-6.663719206041405e-4,9.989576933417468e-4
0613560,"Citrus CDP, California",153,10108,"Citrus CDP, California",115,10150,13560,9481,343,-38,-228,-0.24836601307189543,-0.6647230320699709,0.015136525524337158,0.011330049261083743,0.036177618394684107,-0.003806476263253415,-0.024847569133600363
0613588,"Citrus Heights city, California",3342,84351,"Citrus Heights city, California",3428,87373,13588,83120,1872,86,1556,0.02573309395571514,0.8311965811965812,0.03962015862289718,0.039234088333924666,0.02252165543792108,-3.8607028897251483e-4,0.016712432896003587
0613756,"Claremont city, California",1429,34713,"Claremont city, California",1922,36090,13756,32641,1628,493,294,0.3449965010496851,0.18058968058968058,0.04116613372511739,0.05325574951510113,0.04987592291902822,0.012089615789983743,0.0033798265960729157
0613784,"Clarksburg CDP, California",0,226,"Clarksburg CDP, California",0,456,13784,406,0,0,0,NA,NA,0,0,0,0,0
0613854,"Clay CDP, California",0,1214,"Clay CDP, California",0,1187,13854,821,2,0,-2,NA,-1,0,0,0.00243605359317905,0,-0.00243605359317905
0613882,"Clayton city, California",99,10819,"Clayton city, California",279,12083,13882,7364,73,180,206,1.8181818181818181,2.8219178082191783,0.009150568444403364,0.023090292145990236,0.009913090711569799,0.013939723701586871,0.013177201434420437
0613910,"Clear Creek CDP, California",0,168,"Clear Creek CDP, California",0,210,13910,229,0,0,0,NA,NA,0,0,0,0,0
0613945,"Clearlake city, California",651,15074,"Clearlake city, California",678,15349,13945,11804,514,27,164,0.041474654377880185,0.31906614785992216,0.043186944407589224,0.044172258779073555,0.04354456116570654,9.853143714843304e-4,6.276976133670134e-4
0613966,"Clearlake Oaks CDP, California",136,1498,"Clearlake Oaks CDP, California",13,2265,13966,2389,52,-123,-39,-0.9044117647058824,-0.75,0.09078771695594126,0.005739514348785872,0.021766429468396818,-0.08504820260715538,-0.016026915119610945
0613985,"Clearlake Riviera CDP, California",105,3193,"Clearlake Riviera CDP, California",337,3930,13985,1259,14,232,323,2.2095238095238097,23.071428571428573,0.03288443470090824,0.08575063613231552,0.011119936457505957,0.052866201431407286,0.07463069967480956
0614008,"Cleone CDP, California",0,701,"Cleone CDP, California",0,968,14008,649,1,0,-1,NA,-1,0,0,0.0015408320493066256,0,-0.0015408320493066256
0614106,"Clio CDP, California",0,17,"Clio CDP, California",0,59,14106,104,0,0,0,NA,NA,0,0,0,0,0
0614148,"Clipper Mills CDP, California",0,98,"Clipper Mills CDP, California",0,335,14148,188,1,0,-1,NA,-1,0,0,0.005319148936170213,0,-0.005319148936170213
0614190,"Cloverdale city, California",26,8212,"Cloverdale city, California",69,8754,14190,5114,8,43,61,1.6538461538461537,7.625,0.0031660983925962008,0.007882111034955449,0.001564333202972233,0.004716012642359248,0.006317777831983216
0614218,"Clovis city, California",3126,91166,"Clovis city, California",3164,109160,14218,51754,870,38,2294,0.01215611004478567,2.636781609195402,0.034289099006208454,0.028984976181751557,0.016810294856436217,-0.0053041228244568965,0.01217468132531534
0614232,"Clyde CDP, California",0,604,"Clyde CDP, California",0,792,14232,517,5,0,-5,NA,-1,0,0,0.009671179883945842,0,-0.009671179883945842
0614260,"Coachella city, California",315,38144,"Coachella city, California",291,45181,14260,17059,173,-24,118,-0.0761904761904762,0.6820809248554913,0.008258179530201342,0.006440760496668954,0.010141274400609648,-0.0018174190335323885,-0.0037005139039406948
0614274,"Coalinga city, California",1289,13086,"Coalinga city, California",490,16906,14274,8236,66,-799,424,-0.6198603568657874,6.424242424242424,0.09850221610881858,0.028983792736306635,0.008013598834385623,-0.06951842337251195,0.02097019390192101
0614288,"Coarsegold CDP, California",0,1606,"Coarsegold CDP, California",0,1585,14288,880,7,0,-7,NA,-1,0,0,0.007954545454545454,0,-0.007954545454545454
0614302,"Cobb CDP, California",0,1938,"Cobb CDP, California",0,1011,14302,1477,2,0,-2,NA,-1,0,0,0.0013540961408259986,0,-0.0013540961408259986
0614406,"Coffee Creek CDP, California",0,177,"Coffee Creek CDP, California",0,197,14406,187,0,0,0,NA,NA,0,0,0,0,0
0614442,"Cohasset CDP, California",9,783,"Cohasset CDP, California",0,631,14442,735,0,-9,0,-1,NA,0.011494252873563218,0,0,-0.011494252873563218,0
0614450,"Cold Springs CDP (El Dorado County), California",0,562,"Cold Springs CDP (El Dorado County), California",0,582,14450,104,0,0,0,NA,NA,0,0,0,0,0
0614454,"Cold Springs CDP (Tuolumne County), California",0,306,"Cold Springs CDP (Tuolumne County), California",0,51,14454,146,0,0,0,NA,NA,0,0,0,0,0
0614484,"Coleville CDP, California",16,605,"Coleville CDP, California",0,464,14484,451,17,-16,-17,-1,-1,0.026446280991735537,0,0.037694013303769404,-0.026446280991735537,-0.037694013303769404
0614498,"Colfax city, California",0,1766,"Colfax city, California",78,2057,14498,1287,6,78,72,NA,12,0,0.037919299951385516,0.004662004662004662,0.037919299951385516,0.03325729528938085
0614554,"College City CDP, California",0,92,"College City CDP, California",0,170,14554,284,1,0,-1,NA,-1,0,0,0.0035211267605633804,0,-0.0035211267605633804
0614708,"Collierville CDP, California",16,2131,"Collierville CDP, California",0,2698,14708,1684,15,-16,-15,-1,-1,0.007508212106992022,0,0.008907363420427554,-0.007508212106992022,-0.008907363420427554
0614736,"Colma town, California",23,1527,"Colma town, California",40,1302,14736,1073,19,17,21,0.7391304347826086,1.105263157894737,0.015062213490504257,0.030721966205837174,0.017707362534948742,0.015659752715332917,0.013014603670888431
0614764,"Coloma CDP, California",0,481,"Coloma CDP, California",2,427,14764,552,3,2,-1,NA,-0.3333333333333333,0,0.00468384074941452,0.005434782608695652,0.00468384074941452,-7.509418592811321e-4
0614890,"Colton city, California",5533,52187,"Colton city, California",4042,54580,14890,40588,3527,-1491,515,-0.2694740647026929,0.14601644457045648,0.10602257267135494,0.07405643092707952,0.08689760520350842,-0.03196614174427542,-0.012841174276428904
0614904,"Columbia CDP, California",0,2504,"Columbia CDP, California",0,2226,14904,2343,13,0,-13,NA,-1,0,0,0.005548442168160478,0,-0.005548442168160478
0614946,"Colusa city, California",46,5942,"Colusa city, California",165,6106,14946,5380,22,119,143,2.5869565217391304,6.5,0.007741501178054527,0.027022600720602686,0.004089219330855019,0.01928109954254816,0.022933381389747667
0614974,"Commerce city, California",442,12758,"Commerce city, California",213,12830,14974,12131,95,-229,118,-0.5180995475113123,1.2421052631578948,0.03464492867220567,0.016601714731098987,0.007831176325117468,-0.018043213941106685,0.008770538405981519
0615030,"Comptche CDP, California",0,96,"Comptche CDP, California",0,99,15030,90,0,0,0,NA,NA,0,0,0,0,0
0615044,"Compton city, California",31921,95761,"Compton city, California",28022,96803,15044,89863,49462,-3899,-21440,-0.12214529619999373,-0.43346407343010795,0.3333402951097002,0.28947449975723893,0.5504156326853099,-0.04386579535246127,-0.260941132928071
0616000,"Concord city, California",3699,121326,"Concord city, California",4359,129183,16000,111307,2622,660,1737,0.17842660178426603,0.6624713958810069,0.030488106424014637,0.03374282993892385,0.023556469943489627,0.0032547235149092135,0.010186359995434224
0616035,"Concow CDP, California",16,793,"Concow CDP, California",0,553,16035,737,6,-16,-6,-1,-1,0.0201765447667087,0,0.008141112618724558,-0.0201765447667087,-0.008141112618724558
0616210,"Copperopolis CDP, California",129,4021,"Copperopolis CDP, California",84,4361,16210,1250,13,-45,71,-0.3488372093023256,5.461538461538462,0.03208157174832131,0.019261637239165328,0.0104,-0.012819934509155983,0.0088616372391653285
0616224,"Corcoran city, California",3212,25136,"Corcoran city, California",2645,22156,16224,14982,2421,-567,224,-0.1765255292652553,0.09252375051631558,0.1277848504137492,0.11938075464885359,0.1615939126952343,-0.00840409576489562,-0.042213158046380705
0616322,"Corning city, California",0,7546,"Corning city, California",73,7590,16322,5915,17,73,56,NA,3.2941176470588234,0,0.009617918313570487,0.002874049027895182,0.009617918313570487,0.006743869285675305
0616350,"Corona city, California",8469,150497,"Corona city, California",9557,166972,16350,78928,2138,1088,7419,0.12846853229424962,3.470065481758653,0.056273546981002946,0.05723714155666818,0.027087978917494426,9.635945756652359e-4,0.030149162639173756
0616378,"Coronado city, California",675,19721,"Coronado city, California",851,23639,16378,26555,1819,176,-968,0.2607407407407407,-0.5321605277625069,0.0342274732518635,0.035999830788104405,0.06849934099039728,0.001772357536240908,-0.03249951020229288
0616420,"Coronita CDP, California",53,2611,"Coronita CDP, California",16,3383,16420,2401,29,-37,-13,-0.6981132075471698,-0.4482758620689655,0.020298736116430488,0.004729530002955957,0.012078300708038317,-0.01556920611347453,-0.007348770705082361
0616434,"Corralitos CDP, California",16,2692,"Corralitos CDP, California",0,2160,16434,2095,2,-16,-2,-1,-1,0.005943536404160475,0,9.546539379474941e-4,-0.005943536404160475,-9.546539379474941e-4
0616462,"Corte Madera town, California",68,9110,"Corte Madera town, California",228,9838,16462,8172,76,160,152,2.3529411764705883,2,0.007464324917672887,0.02317544216304127,0.00930004894762604,0.015711117245368382,0.013875393215415229
0616532,"Costa Mesa city, California",1314,109316,"Costa Mesa city, California",2065,113159,16532,97136,1289,751,776,0.571537290715373,0.6020170674941815,0.012020198324124556,0.01824865896658684,0.013270054356778126,0.006228460642462283,0.004978604609808713
0616560,"Cotati city, California",115,7073,"Cotati city, California",46,7454,16560,5487,133,-69,-87,-0.6,-0.6541353383458647,0.01625901314859324,0.006171183257311511,0.024239110625113906,-0.01008782989128173,-0.018067927367802397
0616580,"Coto de Caza CDP, California",130,15453,"Coto de Caza CDP, California",154,15056,16580,2727,14,24,140,0.18461538461538463,10,0.008412605966479001,0.010228480340063762,0.005133846718005134,0.0018158743735847607,0.005094633622058628
0616630,"Cottonwood CDP, California",11,3072,"Cottonwood CDP, California",0,3243,16630,2564,6,-11,-6,-1,-1,0.0035807291666666665,0,0.00234009360374415,-0.0035807291666666665,-0.00234009360374415
0616644,"Coultervillle CDP, California",0,162,"Coulterville CDP, California",0,60,16644,227,0,0,0,NA,NA,0,0,0,0,0
0616651,"Country Club CDP, California",682,8819,"Country Club CDP, California",729,9977,16651,9320,238,47,491,0.0689149560117302,2.063025210084034,0.0773330309558907,0.07306805653001905,0.025536480686695277,-0.004264974425871648,0.04753157584332377
0616714,"Courtland CDP, California",0,371,"Courtland CDP, California",0,179,16714,434,0,0,0,NA,NA,0,0,0,0,0
0616728,"Covelo CDP, California",5,1347,"Covelo CDP, California",19,1140,16728,1057,4,14,15,2.8,3.75,0.003711952487008166,0.016666666666666666,0.003784295175023652,0.0129547141796585,0.012882371491643015
0616742,"Covina city, California",2288,47533,"Covina city, California",1811,48095,16742,43359,1770,-477,41,-0.208479020979021,0.023163841807909605,0.04813497990869501,0.03765464185466265,0.040821974676537746,-0.01048033805403236,-0.0031673328218750976
0616762,"Cowan CDP, California",0,350,"Cowan CDP, California",0,498,16762,281,0,0,0,NA,NA,0,0,0,0,0
0617022,"Crescent City city, California",844,7676,"Crescent City city, California",516,6676,17022,4827,28,-328,488,-0.3886255924170616,17.428571428571427,0.10995310057321521,0.07729179149191133,0.00580070437124508,-0.03266130908130388,0.07149108712066625
0617050,"Crescent Mills CDP, California",0,118,"Crescent Mills CDP, California",0,93,17050,256,0,0,0,NA,NA,0,0,0,0,0
0617078,"Cressey CDP, California",0,692,"Cressey CDP, California",0,340,17078,390,1,0,-1,NA,-1,0,0,0.002564102564102564,0,-0.002564102564102564
0617106,"Crest CDP, California",0,2144,"Crest CDP, California",25,2765,17106,2674,7,25,18,NA,2.5714285714285716,0,0.009041591320072333,0.002617801047120419,0.009041591320072333,0.006423790272951914
0617162,"Crestline CDP, California",75,8936,"Crestline CDP, California",191,8709,17162,9002,61,116,130,1.5466666666666666,2.1311475409836067,0.008393017009847807,0.021931335400160755,0.006776271939568985,0.013538318390312947,0.01515506346059177
0617204,"Crestmore Heights CDP, California",0,290,NA,NA,NA,17204,162,5,NA,NA,NA,NA,0,NA,0.030864197530864196,NA,NA
0617232,"Creston CDP, California",0,67,"Creston CDP, California",0,33,17232,68,0,0,0,NA,NA,0,0,0,0,0
0617267,"C-Road CDP, California",0,268,"C-Road CDP, California",0,140,17267,128,0,0,0,NA,NA,0,0,0,0,0
0617274,"Crockett CDP, California",32,3298,"Crockett CDP, California",239,3265,17274,3249,36,207,203,6.46875,5.638888888888889,0.009702850212249849,0.07320061255742726,0.0110803324099723,0.0634977623451774,0.06212028014745496
0617288,"Cromberg CDP, California",0,119,"Cromberg CDP, California",0,316,17288,247,0,0,0,NA,NA,0,0,0,0,0
0617372,"Crowley Lake CDP, California",0,554,"Crowley Lake CDP, California",0,1077,17372,491,0,0,0,NA,NA,0,0,0,0,0
0617428,"Crows Landing CDP, California",0,529,"Crows Landing CDP, California",0,305,17428,357,0,0,0,NA,NA,0,0,0,0,0
0617498,"Cudahy city, California",163,23854,"Cudahy city, California",170,23890,17498,23743,276,7,-106,0.04294478527607362,-0.38405797101449274,0.006833235516056007,0.007115948095437421,0.011624478793749737,2.8271257938141444e-4,-0.004508530698312315
0617568,"Culver City city, California",4173,38827,"Culver City city, California",3429,39169,17568,38812,4041,-744,-612,-0.17828900071890727,-0.1514476614699332,0.10747675586576351,0.08754372079961194,0.10411728331443883,-0.019933035066151572,-0.01657356251482689
0617610,"Cupertino city, California",509,56498,"Cupertino city, California",548,60257,17610,46103,446,39,102,0.07662082514734773,0.22869955156950672,0.009009168466140395,0.009094379076289892,0.009673990846582652,8.521061014949739e-5,-5.796117702927591e-4
0617708,"Cutler CDP, California",18,5058,"Cutler CDP, California",0,5214,17708,4450,9,-18,-9,-1,-1,0.0035587188612099642,0,0.0020224719101123597,-0.0035587188612099642,-0.0020224719101123597
0617722,"Cutten CDP, California",0,3041,"Cutten CDP, California",30,2919,17722,1516,10,30,20,NA,2,0,0.010277492291880781,0.006596306068601583,0.010277492291880781,0.0036811862232791976
0617727,"Cuyama CDP, California",0,51,"Cuyama CDP, California",0,17,17727,39,0,0,0,NA,NA,0,0,0,0,0
0617750,"Cypress city, California",1034,47314,"Cypress city, California",1902,48893,17750,42903,873,868,1029,0.839458413926499,1.1786941580756014,0.02185399670287864,0.038901274211032254,0.020348227396685546,0.017047277508153613,0.018553046814346708
0617918,"Daly City city, California",2810,99829,"Daly City city, California",3677,106677,17918,92373,7080,867,-3403,0.3085409252669039,-0.4806497175141243,0.028148133307956607,0.034468535860588505,0.07664577311552077,0.006320402552631898,-0.04217723725493227
0617946,"Dana Point city, California",134,33484,"Dana Point city, California",472,33769,17946,31909,191,338,281,2.5223880597014925,1.4712041884816753,0.004001911360649863,0.013977316473688887,0.005985772039236579,0.009975405113039024,0.007991544434452307
0617988,"Danville town, California",374,41738,"Danville town, California",499,44605,17988,31522,259,125,240,0.3342245989304813,0.9266409266409267,0.008960659351190762,0.011187086649478758,0.008216483725651926,0.0022264272982879963,0.002970602923826832
0617995,"Daphnedale Park CDP, California",0,49,"Daphnedale Park CDP, California",15,209,17995,585,45,15,-30,NA,-0.6666666666666666,0,0.07177033492822966,0.07692307692307693,0.07177033492822966,-0.0051527419948472625
0618030,"Darwin CDP, California",0,30,"Darwin CDP, California",0,100,18030,35,0,0,0,NA,NA,0,0,0,0,0
0618086,"Davenport CDP, California",35,309,"Davenport CDP, California",0,368,18086,362,1,-35,-1,-1,-1,0.11326860841423948,0,0.0027624309392265192,-0.11326860841423948,-0.0027624309392265192
0618100,"Davis city, California",1489,64842,"Davis city, California",1492,68543,18100,46333,1391,3,101,0.0020147750167897917,0.07260963335729691,0.022963511304401468,0.02176735771705353,0.03002179871797639,-0.0011961535873479395,-0.00825444100092286
0618153,"Day Valley CDP, California",0,3256,"Day Valley CDP, California",9,3033,18153,3340,26,9,-17,NA,-0.6538461538461539,0,0.002967359050445104,0.007784431137724551,0.002967359050445104,-0.004817072087279447
0618324,"Deer Park CDP, California",0,1048,"Deer Park CDP, California",0,869,18324,1825,14,0,-14,NA,-1,0,0,0.007671232876712329,0,-0.007671232876712329
0618352,"Del Aire CDP, California",367,9582,"Del Aire CDP, California",883,9990,18352,8167,189,516,694,1.4059945504087195,3.671957671957672,0.03830098100605302,0.08838838838838839,0.02314191257499694,0.05008740738233537,0.06524647581339145
0618394,"Delano city, California",2783,51310,"Delano city, California",2127,52886,18394,23221,540,-656,1587,-0.23571685231764283,2.938888888888889,0.054238939777821085,0.04021858336799909,0.023254812454244003,-0.014020356409821993,0.01696377091375509
0618450,"Delft Colony CDP, California",0,555,"Delft Colony CDP, California",0,715,18450,444,0,0,0,NA,NA,0,0,0,0,0
0618464,"Delhi CDP, California",229,10481,"Delhi CDP, California",184,12301,18464,4066,40,-45,144,-0.1965065502183406,3.6,0.02184906020417899,0.014958133485082514,0.009837678307919331,-0.006890926719096475,0.005120455177163183
0618485,"Delleker CDP, California",9,560,"Delleker CDP, California",0,477,18485,588,2,-9,-2,-1,-1,0.01607142857142857,0,0.003401360544217687,-0.01607142857142857,-0.003401360544217687
0618506,"Del Mar city, California",0,4178,"Del Mar city, California",53,4331,18506,4819,36,53,17,NA,0.4722222222222222,0,0.012237358577695681,0.007470429549699108,0.012237358577695681,0.004766929027996573
0618590,"Del Monte Forest CDP, California",0,4254,"Del Monte Forest CDP, California",58,4105,18590,5131,11,58,47,NA,4.2727272727272725,0,0.01412911084043849,0.0021438316117715845,0.01412911084043849,0.011985279228666906
0618674,"Del Rey CDP, California",0,1767,"Del Rey CDP, California",0,1261,18674,1150,0,0,0,NA,NA,0,0,0,0,0
0618688,"Del Rey Oaks city, California",24,1774,"Del Rey Oaks city, California",58,1525,18688,1661,17,34,41,1.4166666666666667,2.411764705882353,0.013528748590755355,0.0380327868852459,0.010234798314268514,0.02450403829449055,0.02779798857097739
0618695,"Del Rio CDP, California",0,1186,"Del Rio CDP, California",0,1592,18695,848,13,0,-13,NA,-1,0,0,0.015330188679245283,0,-0.015330188679245283
0618856,"Denair CDP, California",0,4329,"Denair CDP, California",0,5101,18856,3693,3,0,-3,NA,-1,0,0,8.123476848090983e-4,0,-8.123476848090983e-4
0618926,"Derby Acres CDP, California",0,401,"Derby Acres CDP, California",0,386,18926,472,1,0,-1,NA,-1,0,0,0.00211864406779661,0,-0.00211864406779661
0618940,"Descanso CDP, California",12,1350,"Descanso CDP, California",0,1568,18940,1346,5,-12,-5,-1,-1,0.008888888888888889,0,0.003714710252600297,-0.008888888888888889,-0.003714710252600297
0618982,"Desert Center CDP, California",0,188,"Desert Center CDP, California",3,216,18982,340,9,3,-6,NA,-0.6666666666666666,0,0.013888888888888888,0.026470588235294117,0.013888888888888888,-0.01258169934640523
0618986,"Desert Edge CDP, California",35,4668,"Desert Edge CDP, California",0,3319,18986,1918,7,-35,-7,-1,-1,0.0074978577549271634,0,0.0036496350364963502,-0.0074978577549271634,-0.0036496350364963502
0618996,"Desert Hot Springs city, California",2129,24675,"Desert Hot Springs city, California",2845,28585,18996,11743,466,716,2379,0.33630812588069514,5.105150214592275,0.08628166160081054,0.0995277243309428,0.03968321553265775,0.013246062730132263,0.05984450879828505
0619022,"Desert Palms CDP, California",16,6745,"Desert Palms CDP, California",241,6755,19022,113,0,225,241,14.0625,NA,0.0023721275018532247,0.035677276091783866,0,0.03330514858993064,0.035677276091783866
0619024,"Desert Shores CDP, California",0,470,"Desert Shores CDP, California",71,574,19024,637,2,71,69,NA,34.5,0,0.12369337979094076,0.0031397174254317113,0.12369337979094076,0.12055366236550905
0619052,"Desert View Highlands CDP, California",78,2450,"Desert View Highlands CDP, California",82,2668,19052,2195,58,4,24,0.05128205128205128,0.41379310344827586,0.03183673469387755,0.03073463268365817,0.02642369020501139,-0.0011021020102193815,0.00431094247864678
0619150,"Diablo CDP, California",0,1071,"Diablo CDP, California",0,448,19150,1164,5,0,-5,NA,-1,0,0,0.00429553264604811,0,-0.00429553264604811
0619155,"Diablo Grande CDP, California",0,285,"Diablo Grande CDP, California",97,889,19155,2,0,97,97,NA,NA,0,0.10911136107986502,0,0.10911136107986502,0.10911136107986502
0619192,"Diamond Bar city, California",1841,55701,"Diamond Bar city, California",2040,56211,19192,53672,3036,199,-996,0.10809342748506247,-0.32806324110671936,0.03305147124827203,0.036291829001441,0.05656580712475779,0.003240357753168971,-0.020273978123316792
0619220,"Diamond Springs CDP, California",49,11327,"Diamond Springs CDP, California",39,11731,19220,9589,14,-10,25,-0.20408163265306123,1.7857142857142858,0.004325946852652953,0.0033245247634472765,0.0014600062571696736,-0.0010014220892056768,0.0018645185062776029
0619262,"Dillon Beach CDP, California",0,163,"Dillon Beach CDP, California",0,254,19262,279,1,0,-1,NA,-1,0,0,0.0035842293906810036,0,-0.0035842293906810036
0619318,"Dinuba city, California",0,20823,"Dinuba city, California",110,24015,19318,13817,31,110,79,NA,2.5483870967741935,0,0.004580470539246304,0.0022436129405804446,0.004580470539246304,0.00233685759866586
0619339,"Discovery Bay CDP, California",385,11438,"Discovery Bay CDP, California",783,16159,19339,5403,66,398,717,1.0337662337662337,10.863636363636363,0.033659730722154224,0.04845596880995111,0.012215435868961688,0.014796238087796884,0.03624053294098942
0619402,"Dixon city, California",569,17924,"Dixon city, California",383,20084,19402,10639,137,-186,246,-0.3268892794376098,1.7956204379562044,0.031745146172729305,0.019069906393148775,0.012877150108092867,-0.01267523977958053,0.006192756285055908
0619406,"Dixon Lane-Meadow Creek CDP, California",0,2660,"Dixon Lane-Meadow Creek CDP, California",12,2664,19406,2561,2,12,10,NA,5,0,0.0045045045045045045,7.809449433814916e-4,0.0045045045045045045,0.003723559561123013
0619416,"Dobbins CDP, California",0,354,"Dobbins CDP, California",21,346,19416,542,1,21,20,NA,20,0,0.06069364161849711,0.0018450184501845018,0.06069364161849711,0.0588486231683126
0619440,"Dogtown CDP, California",0,2299,"Dogtown CDP, California",0,2643,19440,1782,14,0,-14,NA,-1,0,0,0.007856341189674524,0,-0.007856341189674524
0619455,"Dollar Point CDP, California",0,1090,"Dollar Point CDP, California",0,805,19455,1449,4,0,-4,NA,-1,0,0,0.0027605244996549345,0,-0.0027605244996549345
0619570,"Dorrington CDP, California",0,574,"Dorrington CDP, California",0,278,19570,520,0,0,0,NA,NA,0,0,0,0,0
0619584,"Dorris city, California",0,797,"Dorris city, California",11,908,19584,889,7,11,4,NA,0.5714285714285714,0,0.012114537444933921,0.007874015748031496,0.012114537444933921,0.004240521696902425
0619612,"Dos Palos city, California",132,4904,"Dos Palos city, California",86,5351,19612,4162,154,-46,-68,-0.3484848484848485,-0.44155844155844154,0.026916802610114192,0.01607176228742291,0.03700144161460836,-0.01084504032269128,-0.02092967932718545
0619654,"Dos Palos Y CDP, California",0,372,"Dos Palos Y CDP, California",0,229,19654,420,4,0,-4,NA,-1,0,0,0.009523809523809525,0,-0.009523809523809525
0619724,"Douglas City CDP, California",0,830,"Douglas City CDP, California",0,625,19724,735,1,0,-1,NA,-1,0,0,0.0013605442176870747,0,-0.0013605442176870747
0619766,"Downey city, California",4008,110921,"Downey city, California",3800,112322,19766,91444,3068,-208,732,-0.05189620758483034,0.23859191655801826,0.03613382497453142,0.033831306422606434,0.033550588338217925,-0.0023025185519249883,2.807180843885093e-4
0619794,"Downieville CDP, California",0,213,"Downieville CDP, California",0,158,19794,355,0,0,0,NA,NA,0,0,0,0,0
0619878,"Doyle CDP, California",0,372,"Doyle CDP, California",0,622,19878,422,0,0,0,NA,NA,0,0,0,0,0
0619976,"Drytown CDP, California",0,210,"Drytown CDP, California",0,21,19976,125,0,0,0,NA,NA,0,0,0,0,0
0619990,"Duarte city, California",1561,21380,"Duarte city, California",1313,21559,19990,20847,1854,-248,-541,-0.15887251761691223,-0.2918015102481122,0.07301216089803554,0.06090263926898279,0.08893365951935531,-0.012109521629052752,-0.028031020250372518
0620018,"Dublin city, California",3473,42657,"Dublin city, California",2265,61240,20018,23334,2669,-1208,-404,-0.34782608695652173,-0.15136755339078306,0.08141688351267085,0.0369856303069889,0.1143824462158224,-0.04443125320568195,-0.0773968159088335
0620032,"Ducor CDP, California",0,444,"Ducor CDP, California",0,636,20032,426,0,0,0,NA,NA,0,0,0,0,0
0620228,"Dunnigan CDP, California",126,948,"Dunnigan CDP, California",79,1459,20228,655,160,-47,-81,-0.373015873015873,-0.50625,0.13291139240506328,0.05414667580534613,0.24427480916030533,-0.07876471659971715,-0.1901281333549592
0620242,"Dunsmuir city, California",30,1782,"Dunsmuir city, California",0,1724,20242,2129,67,-30,-67,-1,-1,0.016835016835016835,0,0.03147017379051198,-0.016835016835016835,-0.03147017379051198
0620270,"Durham CDP, California",9,5632,"Durham CDP, California",112,5987,20270,4884,6,103,106,11.444444444444445,17.666666666666668,0.0015980113636363637,0.018707198931017206,0.0012285012285012285,0.01710918756738084,0.017478697702515977
0620284,"Dustin Acres CDP, California",0,606,"Dustin Acres CDP, California",40,641,20284,468,0,40,40,NA,NA,0,0.062402496099843996,0,0.062402496099843996,0.062402496099843996
0620298,"Dutch Flat CDP, California",0,154,"Dutch Flat CDP, California",0,178,20298,176,0,0,0,NA,NA,0,0,0,0,0
0620424,"Eagleville CDP, California",0,70,"Eagleville CDP, California",0,52,20424,102,0,0,0,NA,NA,0,0,0,0,0
0620438,"Earlimart CDP, California",0,6596,"Earlimart CDP, California",0,8668,20438,6287,87,0,-87,NA,-1,0,0,0.013838078574836965,0,-0.013838078574836965
0620598,"East Foothills CDP, California",140,7675,"East Foothills CDP, California",126,6233,20598,7712,232,-14,-106,-0.1,-0.45689655172413796,0.018241042345276872,0.020214984758543237,0.03008298755186722,0.001973942413266365,-0.009868002793323984
0620697,"East Hemet CDP, California",862,19962,"East Hemet CDP, California",833,20211,20697,15800,87,-29,746,-0.033642691415313224,8.574712643678161,0.043182045887185654,0.04121517985255554,0.005506329113924051,-0.001966866034630116,0.03570885073863149
0620746,"East La Mirada CDP, California",44,10177,NA,NA,NA,20746,9367,96,NA,NA,NA,NA,0.004323474501326521,NA,0.010248745596242127,NA,NA
0620802,"East Los Angeles CDP, California",338,123136,"East Los Angeles CDP, California",586,121187,20802,126608,1779,248,-1193,0.7337278106508875,-0.670601461495222,0.0027449324324324326,0.004835502157822209,0.01405124478705927,0.002090569725389776,-0.00921574262923706
0620900,"East Nicolaus CDP, California",0,349,"East Nicolaus CDP, California",0,273,20900,300,0,0,0,NA,NA,0,0,0,0,0
0620907,"East Oakdale CDP, California",0,2972,"East Oakdale CDP, California",0,2839,20907,1677,10,0,-10,NA,-1,0,0,0.005963029218843173,0,-0.005963029218843173
0620928,"Easton CDP, California",0,2017,"Easton CDP, California",9,2018,20928,1877,16,9,-7,NA,-0.4375,0,0.0044598612487611496,0.008524240809802876,0.0044598612487611496,-0.004064379561041727
0620942,"East Orosi CDP, California",0,263,"East Orosi CDP, California",0,798,20942,433,3,0,-3,NA,-1,0,0,0.006928406466512702,0,-0.006928406466512702
0620956,"East Palo Alto city, California",4829,27894,"East Palo Alto city, California",3447,29593,20956,23451,10071,-1382,-6624,-0.286187616483744,-0.6577301161751564,0.17311966731196674,0.11648024870746461,0.42944863758475116,-0.056639418604502126,-0.31296838887728656
0620984,"East Pasadena CDP, California",39,5752,"East Pasadena CDP, California",198,6143,20984,5910,112,159,86,4.076923076923077,0.7678571428571429,0.006780250347705146,0.032231808562591564,0.01895093062605753,0.02545155821488642,0.013280877936534034
0621012,"East Porterville CDP, California",55,6498,"East Porterville CDP, California",1,6291,21012,5072,32,-54,-31,-0.9818181818181818,-0.96875,0.008464142813173285,1.5895724050230488e-4,0.006309148264984227,-0.00830518557267098,-0.006150191024481922
0621026,"East Quincy CDP, California",52,2706,"East Quincy CDP, California",0,2210,21026,2434,75,-52,-75,-1,-1,0.019216555801921657,0,0.030813475760065736,-0.019216555801921657,-0.030813475760065736
0621034,"East Rancho Dominguez CDP, California",2596,13599,"East Rancho Dominguez CDP, California",2230,15792,21034,12200,5233,-366,-3003,-0.14098613251155623,-0.573858207529142,0.19089638944040002,0.14121073961499495,0.42893442622950817,-0.049685649825405076,-0.2877236866145132
0621061,"East Richmond Heights CDP, California",567,3210,"East Richmond Heights CDP, California",507,3162,21061,3281,558,-60,-51,-0.10582010582010581,-0.0913978494623656,0.1766355140186916,0.1603415559772296,0.17007010057909175,-0.016293958041461998,-0.009728544601862149
0621096,"East San Gabriel CDP, California",120,15131,"East San Gabriel CDP, California",242,16256,21096,12736,255,122,-13,1.0166666666666666,-0.050980392156862744,0.007930738219549269,0.014886811023622047,0.020021984924623117,0.006956072804072778,-0.0051351739010010704
0621138,"East Shore CDP, California",0,298,"East Shore CDP, California",0,128,21138,209,0,0,0,NA,NA,0,0,0,0,0
0621188,"East Sonora CDP, California",0,2248,"East Sonora CDP, California",0,2278,21188,1665,4,0,-4,NA,-1,0,0,0.0024024024024024023,0,-0.0024024024024024023
0621210,"East Tulare Villa CDP, California",0,1249,"East Tulare Villa CDP, California",0,853,21210,736,4,0,-4,NA,-1,0,0,0.005434782608695652,0,-0.005434782608695652
0621230,"Eastvale CDP, California",5406,49131,"Eastvale city, California",5351,62046,21230,3151,36,-55,5315,-0.010173880873103959,147.63888888888889,0.11003236245954692,0.08624246526770461,0.011424944462075532,-0.02378989719184231,0.07481752080562908
0621530,"Edgewood CDP, California",0,49,"Edgewood CDP, California",0,37,21530,64,0,0,0,NA,NA,0,0,0,0,0
0621558,"Edmundson Acres CDP, California",15,229,"Edmundson Acres CDP, California",5,357,21558,232,2,-10,3,-0.6666666666666666,1.5,0.06550218340611354,0.014005602240896359,0.008620689655172414,-0.05149658116521718,0.005384912585723945
0621565,"Edna CDP, California",0,30,"Edna CDP, California",0,172,21565,93,0,0,0,NA,NA,0,0,0,0,0
0621600,"Edwards AFB CDP, California",346,3565,"Edwards AFB CDP, California",147,2545,21600,7423,851,-199,-704,-0.5751445086705202,-0.827262044653349,0.097054698457223,0.05776031434184676,0.1146436750639903,-0.039294384115376245,-0.05688336072214354
0621712,"El Cajon city, California",5668,97932,"El Cajon city, California",6168,103186,21712,88820,2590,500,3578,0.08821453775582216,1.3814671814671815,0.057876894171465916,0.05977555094683387,0.029160099076784508,0.001898656775367956,0.030615451870049364
0621782,"El Centro city, California",1470,41581,"El Centro city, California",950,44003,21782,33247,1433,-520,-483,-0.35374149659863946,-0.33705512909979063,0.03535268512060797,0.021589437083835192,0.04310163323006587,-0.013763248036772778,-0.021512196146230678
0621796,"El Cerrito city, California",1772,23320,"El Cerrito city, California",1260,25398,21796,22940,2120,-512,-860,-0.28893905191873587,-0.4056603773584906,0.07598627787307033,0.04961020552799433,0.09241499564080209,-0.026376072345075996,-0.04280479011280776
0621810,"El Cerrito CDP, California",31,5157,"El Cerrito CDP, California",31,5630,21810,4411,32,0,-1,0,-0.03125,0.0060112468489431845,0.005506216696269982,0.007254590795737928,-5.050301526732023e-4,-0.0017483740994679456
0621880,"El Dorado Hills CDP, California",481,43179,"El Dorado Hills CDP, California",626,46593,21880,11014,85,145,541,0.30145530145530147,6.364705882352941,0.011139674378748929,0.013435494602193463,0.007717450517523153,0.002295820223444534,0.00571804408467031
0621894,"Eldridge CDP, California",40,1757,"Eldridge CDP, California",0,1422,21894,1144,7,-40,-7,-1,-1,0.022766078542970972,0,0.006118881118881119,-0.022766078542970972,-0.006118881118881119
0621936,"El Granada CDP, California",17,4669,"El Granada CDP, California",38,6102,21936,4426,27,21,11,1.2352941176470589,0.4074074074074074,0.0036410366245448705,0.006227466404457555,0.006100316312697696,0.0025864297799126847,1.271500917598596e-4
0621964,"Elizabeth Lake CDP, California",39,1609,"Elizabeth Lake CDP, California",9,1744,21964,1485,9,-30,0,-0.7692307692307693,0,0.024238657551274082,0.005160550458715597,0.006060606060606061,-0.019078107092558486,-9.00055601890464e-4
0622006,"Elk Creek CDP, California",0,118,"Elk Creek CDP, California",0,183,22006,260,32,0,-32,NA,-1,0,0,0.12307692307692308,0,-0.12307692307692308
0622020,"Elk Grove city, California",15744,141200,"Elk Grove city, California",19700,170825,22020,33348,1101,3956,18599,0.25127032520325204,16.892824704813805,0.1115014164305949,0.11532269866822772,0.03301547319179561,0.0038212822376328254,0.08230722547643211
0622034,"Elkhorn CDP, California",0,1720,"Elkhorn CDP, California",0,1153,22034,1458,19,0,-19,NA,-1,0,0,0.013031550068587106,0,-0.013031550068587106
0622146,"Elmira CDP, California",0,153,"Elmira CDP, California",0,244,22146,196,1,0,-1,NA,-1,0,0,0.00510204081632653,0,-0.00510204081632653
0622230,"El Monte city, California",825,113888,"El Monte city, California",672,115517,22230,106117,1046,-153,-374,-0.18545454545454546,-0.3575525812619503,0.007243958977240798,0.005817325588441528,0.009857044582866082,-0.0014266333887992698,-0.004039718994424554
0622286,"El Nido CDP, California",0,250,"El Nido CDP, California",0,338,22286,276,0,0,0,NA,NA,0,0,0,0,0
0622300,"El Paso de Robles (Paso Robles) city, California",1022,28794,"El Paso de Robles (Paso Robles) city, California",353,31822,22300,19446,986,-669,-633,-0.6545988258317026,-0.6419878296146044,0.03549350559144266,0.011092954559738546,0.05070451506736604,-0.024400551031704115,-0.0396115605076275
0622328,"El Portal CDP, California",0,378,"El Portal CDP, California",0,220,22328,476,4,0,-4,NA,-1,0,0,0.008403361344537815,0,-0.008403361344537815
0622360,"El Rancho CDP, California",0,47,"El Rancho CDP, California",0,59,22360,83,0,0,0,NA,NA,0,0,0,0,0
0622370,"El Rio CDP, California",108,6159,"El Rio CDP, California",178,6297,22370,6294,61,70,117,0.6481481481481481,1.9180327868852458,0.01753531417437896,0.028267428934413214,0.00969176993962504,0.010732114760034255,0.018575658994788174
0622412,"El Segundo city, California",276,16534,"El Segundo city, California",626,16731,22412,15171,154,350,472,1.2681159420289856,3.064935064935065,0.0166928752872868,0.03741557587711434,0.010150945883593698,0.020722700589827538,0.02726462999352064
0622454,"El Sobrante CDP (Contra Costa County), California",1539,13489,"El Sobrante CDP (Contra Costa County), California",1571,13818,22454,9192,535,32,1036,0.02079272254710851,1.936448598130841,0.11409296463785307,0.11369228542480822,0.05820278503046127,-4.0067921304484666e-4,0.05548950039434695
0622457,"El Sobrante CDP (Riverside County), California",920,11122,"El Sobrante CDP (Riverside County), California",1145,13881,22457,3409,137,225,1008,0.24456521739130435,7.357664233576642,0.0827189354432656,0.08248685253223831,0.040187738339689055,-2.3208291102728984e-4,0.04229911419254925
0622510,"El Verano CDP, California",0,3746,"El Verano CDP, California",59,3295,22510,3498,11,59,48,NA,4.363636363636363,0,0.017905918057663128,0.0031446540880503146,0.017905918057663128,0.014761263969612814
0622524,"Elverta CDP, California",44,5044,"Elverta CDP, California",171,5606,22524,5700,253,127,-82,2.8863636363636362,-0.3241106719367589,0.008723235527359239,0.03050303246521584,0.0443859649122807,0.021779796937856602,-0.013882932447064861
0622587,"Emerald Lake Hills CDP, California",52,4445,"Emerald Lake Hills CDP, California",35,4721,22587,3328,24,-17,11,-0.3269230769230769,0.4583333333333333,0.011698537682789651,0.0074136835416225375,0.007211538461538462,-0.004284854141167114,2.0214508008407558e-4
0622594,"Emeryville city, California",1377,9393,"Emeryville city, California",1793,11899,22594,5797,1360,416,433,0.3021060275962237,0.31838235294117645,0.14659853082082402,0.1506849315068493,0.23460410557184752,0.004086400686025282,-0.08391917406499821
0622622,"Empire CDP, California",0,3763,"Empire CDP, California",39,4051,22622,3992,27,39,12,NA,0.4444444444444444,0,0.009627252530239447,0.006763527054108216,0.009627252530239447,0.002863725476131231
0622678,"Encinitas city, California",283,58761,"Encinitas city, California",513,62780,22678,55534,321,230,192,0.8127208480565371,0.5981308411214953,0.004816119535065775,0.00817139216310927,0.0057802427341808625,0.003355272628043495,0.002391149428928408
0622790,"Escalon city, California",61,7054,"Escalon city, California",73,7538,22790,4626,23,12,50,0.19672131147540983,2.1739130434782608,0.008647575843493054,0.009684266383656142,0.004971897968006917,0.0010366905401630877,0.004712368415649225
0622804,"Escondido city, California",2562,140998,"Escondido city, California",3363,151300,22804,109423,1587,801,1776,0.3126463700234192,1.1190926275992439,0.018170470503127704,0.02222736285525446,0.014503349387240343,0.004056892352126758,0.007724013468014119
0622846,"Esparto CDP, California",0,2720,"Esparto CDP, California",0,3272,22846,1767,9,0,-9,NA,-1,0,0,0.0050933786078098476,0,-0.0050933786078098476
0622972,"Etna city, California",0,650,"Etna city, California",18,735,22972,839,4,18,14,NA,3.5,0,0.024489795918367346,0.004767580452920143,0.024489795918367346,0.019722215465447203
0623000,"Eucalyptus Hills CDP, California",238,5867,"Eucalyptus Hills CDP, California",378,6129,23000,4422,8,140,370,0.5882352941176471,46.25,0.040565876938810294,0.06167400881057269,0.0018091361374943465,0.021108131871762394,0.05986487267307834
0623042,"Eureka city, California",510,26954,"Eureka city, California",549,26966,23042,27025,387,39,162,0.07647058823529412,0.4186046511627907,0.018921124879424205,0.02035897055551435,0.014320074005550416,0.0014378456760901458,0.006038896549963934
0623126,"Exeter city, California",8,10139,"Exeter city, California",157,10474,23126,7300,16,149,141,18.625,8.8125,7.890324489594634e-4,0.014989497804086309,0.002191780821917808,0.014200465355126845,0.0127977169821685
0623150,"Fairbanks Ranch CDP, California",0,1976,"Fairbanks Ranch CDP, California",0,2085,23150,1651,11,0,-11,NA,-1,0,0,0.006662628709872804,0,-0.006662628709872804
0623168,"Fairfax town, California",58,7346,"Fairfax town, California",34,7578,23168,6963,90,-24,-56,-0.41379310344827586,-0.6222222222222222,0.007895453307922679,0.0044866719451042494,0.012925463162429988,-0.0034087813628184294,-0.008438791217325738
0623182,"Fairfield city, California",17039,103698,"Fairfield city, California",17531,115282,23182,78768,10719,492,6812,0.028874933974998532,0.635507043567497,0.1643136801095489,0.15207057476449054,0.13608318098720293,-0.012243105345058347,0.015987393777287612
0623210,"Fairmead CDP, California",108,935,"Fairmead CDP, California",6,1105,23210,1069,175,-102,-169,-0.9444444444444444,-0.9657142857142857,0.11550802139037433,0.005429864253393665,0.1637043966323667,-0.11007815713698067,-0.15827453237897302
0623294,"Fair Oaks CDP, California",366,30715,"Fair Oaks CDP, California",859,31032,23294,30446,451,493,408,1.3469945355191257,0.9046563192904656,0.011916001953442943,0.027681103377159063,0.014813111738816265,0.01576510142371612,0.012867991638342798
0623350,"Fairview CDP, California",1776,9812,"Fairview CDP, California",2011,10532,23350,8958,1708,235,303,0.13231981981981983,0.17740046838407494,0.18100285364859356,0.19094189137865553,0.1906675597231525,0.009939037730061967,2.743316555030295e-4
0623462,"Fallbrook CDP, California",595,29892,"Fallbrook CDP, California",819,31701,23462,24382,417,224,402,0.3764705882352941,0.9640287769784173,0.019904991302020607,0.025835147156241127,0.01710278073989008,0.00593015585422052,0.008732366416351046
0623532,"Fall River Mills CDP, California",0,545,"Fall River Mills CDP, California",3,274,23532,869,5,3,-2,NA,-0.4,0,0.010948905109489052,0.005753739930955121,0.010948905109489052,0.0051951651785339305
0623616,"Farmersville city, California",33,10283,"Farmersville city, California",66,10716,23616,6265,10,33,56,1,5.6,0.003209180200330643,0.006159014557670772,0.0015961691939345571,0.0029498343573401294,0.004562845363736215
0623630,"Farmington CDP, California",29,300,"Farmington CDP, California",0,172,23630,247,1,-29,-1,-1,-1,0.09666666666666666,0,0.004048582995951417,-0.09666666666666666,-0.004048582995951417
0623812,"Fellows CDP, California",0,162,"Fellows CDP, California",0,51,23812,299,0,0,0,NA,NA,0,0,0,0,0
0623826,"Felton CDP, California",81,4528,"Felton CDP, California",0,3633,23826,4220,34,-81,-34,-1,-1,0.0178886925795053,0,0.008056872037914692,-0.0178886925795053,-0.008056872037914692
0623910,"Ferndale city, California",0,1693,"Ferndale city, California",0,1377,23910,1331,18,0,-18,NA,-1,0,0,0.013523666416228399,0,-0.013523666416228399
0623973,"Fetters Hot Springs-Agua Caliente CDP, California",32,3504,"Fetters Hot Springs-Agua Caliente CDP, California",0,4374,23973,2745,31,-32,-31,-1,-1,0.0091324200913242,0,0.011293260473588343,-0.0091324200913242,-0.011293260473588343
0623980,"Fiddletown CDP, California",0,83,"Fiddletown CDP, California",0,324,23980,261,0,0,0,NA,NA,0,0,0,0,0
0624008,"Fieldbrook CDP, California",0,927,"Fieldbrook CDP, California",3,880,24008,895,1,3,2,NA,2,0,0.003409090909090909,0.0011173184357541898,0.003409090909090909,0.002291772473336719
0624022,"Fields Landing CDP, California",0,259,"Fields Landing CDP, California",0,251,24022,302,11,0,-11,NA,-1,0,0,0.03642384105960265,0,-0.03642384105960265
0624092,"Fillmore city, California",71,14721,"Fillmore city, California",52,15664,24092,12083,25,-19,27,-0.2676056338028169,1.08,0.004823041912913525,0.003319713993871297,0.0020690225937267234,-0.0015033279190422282,0.0012506914001445737
0624134,"Firebaugh city, California",26,7373,"Firebaugh city, California",0,8300,24134,4827,87,-26,-87,-1,-1,0.0035263800352638005,0,0.018023617153511497,-0.0035263800352638005,-0.018023617153511497
0624218,"Fish Camp CDP, California",0,0,"Fish Camp CDP, California",0,93,24218,58,0,0,0,NA,NA,NA,0,0,NA,0
0624477,"Florence-Graham CDP, California",6430,60834,"Florence-Graham CDP, California",4108,65716,24477,57147,13722,-2322,-9614,-0.3611197511664075,-0.7006267307972599,0.10569747180852812,0.06251141274575446,0.2401175914746181,-0.04318605906277366,-0.17760617872886364
0624498,"Florin CDP, California",6504,47869,"Florin CDP, California",5191,47555,24498,36193,4438,-1313,753,-0.2018757687576876,0.16967102298332581,0.13587081409680588,0.10915781726422037,0.12262039620921172,-0.026712996832585503,-0.013462578944991352
0624526,"Floriston CDP, California",0,27,"Floriston CDP, California",0,0,24526,103,0,0,0,NA,NA,0,NA,0,NA,NA
0624568,"Flournoy CDP, California",0,110,"Flournoy CDP, California",0,155,24568,35,0,0,0,NA,NA,0,0,0,0,0
0624638,"Folsom city, California",5111,69068,"Folsom city, California",2663,78159,24638,29802,2949,-2448,-286,-0.478966934063784,-0.09698202780603594,0.07399953668848092,0.03407157205184304,0.09895309039661768,-0.03992796463663788,-0.06488151834477464
0624680,"Fontana city, California",18264,189466,"Fontana city, California",18634,210759,24680,101155,7986,370,10648,0.020258431887866843,1.3333333333333333,0.09639724277706818,0.08841378066891568,0.07894814888043102,-0.007983462108152498,0.009465631788484669
0624722,"Foothill Farms CDP, California",4002,32800,"Foothill Farms CDP, California",4475,35881,24722,31682,2747,473,1728,0.11819090454772614,0.6290498725882782,0.12201219512195122,0.12471781722917422,0.08670538476106307,0.002705622107222999,0.038012432468111146
0624750,"Forbestown CDP, California",0,355,"Forbestown CDP, California",0,413,24750,245,1,0,-1,NA,-1,0,0,0.004081632653061225,0,-0.004081632653061225
0624764,"Ford City CDP, California",0,3684,"Ford City CDP, California",0,4753,24764,3781,10,0,-10,NA,-1,0,0,0.0026448029621793175,0,-0.0026448029621793175
0624834,"Foresthill CDP, California",0,1895,"Foresthill CDP, California",0,1856,24834,1618,19,0,-19,NA,-1,0,0,0.011742892459826947,0,-0.011742892459826947
0624897,"Forest Meadows CDP, California",0,1551,"Forest Meadows CDP, California",0,1327,24897,944,0,0,0,NA,NA,0,0,0,0,0
0624918,"Forest Ranch CDP, California",0,1335,"Forest Ranch CDP, California",0,772,24918,858,2,0,-2,NA,-1,0,0,0.002331002331002331,0,-0.002331002331002331
0624960,"Forestville CDP, California",0,3380,"Forestville CDP, California",9,3761,24960,3301,7,9,2,NA,0.2857142857142857,0,0.0023929805902685457,0.0021205695243865495,0.0023929805902685457,2.724110658819962e-4
0625030,"Fort Bidwell CDP, California",0,140,"Fort Bidwell CDP, California",1,192,25030,212,0,1,1,NA,NA,0,0.005208333333333333,0,0.005208333333333333,0.005208333333333333
0625058,"Fort Bragg city, California",10,7196,"Fort Bragg city, California",73,7302,25058,6139,29,63,44,6.3,1.5172413793103448,0.0013896609227348527,0.009997261024376883,0.004723896400065157,0.00860760010164203,0.005273364624311726
0625114,"Fort Irwin CDP, California",1425,9107,"Fort Irwin CDP, California",1807,9872,25114,6732,1661,382,146,0.2680701754385965,0.08789885611077664,0.15647304271439552,0.18304294975688817,0.24673202614379086,0.026569907042492652,-0.06368907638690269
0625128,"Fort Jones city, California",0,520,"Fort Jones city, California",0,689,25128,662,0,0,0,NA,NA,0,0,0,0,0
0625296,"Fortuna city, California",133,11646,"Fortuna city, California",69,12210,25296,8788,45,-64,24,-0.48120300751879697,0.5333333333333333,0.011420230121930277,0.005651105651105651,0.0051206190259444695,-0.005769124470824625,5.304866251611817e-4
0625300,"Fort Washington CDP, California",0,432,"Fort Washington CDP, California",0,540,25300,271,11,0,-11,NA,-1,0,0,0.04059040590405904,0,-0.04059040590405904
0625338,"Foster City city, California",539,29746,"Foster City city, California",834,33997,25338,28176,909,295,-75,0.5473098330241187,-0.08250825082508251,0.01812008337255429,0.024531576315557253,0.03226149914821124,0.006411492943002962,-0.007729922832653988
0625380,"Fountain Valley city, California",680,54961,"Fountain Valley city, California",377,56026,25380,54062,512,-303,-135,-0.4455882352941177,-0.263671875,0.012372409526755336,0.006729018669903259,0.009470607820650364,-0.005643390856852077,-0.002741589150747105
0625436,"Fowler city, California",146,5305,"Fowler city, California",55,6527,25436,3240,103,-91,-48,-0.6232876712328768,-0.46601941747572817,0.02752120640904807,0.008426535927685,0.03179012345679012,-0.01909467048136307,-0.023363587529105122
0625488,"Franklin CDP (Merced County), California",120,5177,"Franklin CDP (Merced County), California",65,6929,25488,3730,122,-55,-57,-0.4583333333333333,-0.4672131147540984,0.023179447556499904,0.009380863039399626,0.032707774798927614,-0.013798584517100278,-0.023326911759527988
0625506,"Franklin CDP (Sacramento County), California",0,0,"Franklin CDP (Sacramento County), California",0,82,25506,136,0,0,0,NA,NA,NA,0,0,NA,0
0625534,"Frazier Park CDP, California",0,2393,"Frazier Park CDP, California",0,2587,25534,2177,10,0,-10,NA,-1,0,0,0.004593477262287551,0,-0.004593477262287551
0625576,"Freedom CDP, California",0,2816,"Freedom CDP, California",0,3777,25576,3013,12,0,-12,NA,-1,0,0,0.003982741453700631,0,-0.003982741453700631
0625590,"Freeport CDP, California",0,20,"Freeport CDP, California",0,70,25590,74,0,0,0,NA,NA,0,0,0,0,0
0600135,"Acalanes Ridge CDP, California",0,1612,"Acalanes Ridge CDP, California",0,1134,00135,1164,11,0,-11,NA,-1,0,0,0.009450171821305841,0,-0.009450171821305841
0600156,"Acampo CDP, California",0,25,"Acampo CDP, California",0,204,00156,395,0,0,0,NA,NA,0,0,0,0,0
0600212,"Acton CDP, California",0,7150,"Acton CDP, California",38,7232,00212,5471,81,38,-43,NA,-0.5308641975308642,0,0.005254424778761062,0.01480533723268141,0.005254424778761062,-0.009550912453920347
0600296,"Adelanto city, California",6198,29764,"Adelanto city, California",6377,33660,00296,6896,904,179,5473,0.02888028396256857,6.054203539823009,0.20823814003494154,0.18945335710041591,0.13109048723897912,-0.018784782934525623,0.058362869861436795
0600310,"Adin CDP, California",0,374,"Adin CDP, California",0,171,00310,255,0,0,0,NA,NA,0,0,0,0,0
0600394,"Agoura Hills city, California",390,20328,"Agoura Hills city, California",504,20533,00394,20390,238,114,266,0.2923076923076923,1.1176470588235294,0.019185360094451005,0.024545853017094433,0.011672388425698873,0.005360492922643428,0.01287346459139556
0600450,"Agua Dulce CDP, California",0,2864,"Agua Dulce CDP, California",7,3742,00450,2549,27,7,-20,NA,-0.7407407407407407,0,0.0018706574024585784,0.010592389172224402,0.0018706574024585784,-0.008721731769765824
0600464,"Aguanga CDP, California",41,1430,"Aguanga CDP, California",37,805,00464,525,1,-4,36,-0.0975609756097561,36,0.028671328671328673,0.04596273291925466,0.0019047619047619048,0.017291404247925985,0.044057971014492756
0600478,"Ahwahnee CDP, California",22,2097,"Ahwahnee CDP, California",38,2513,00478,1637,2,16,36,0.7272727272727273,18,0.010491177873152123,0.015121368881814564,0.0012217470983506415,0.004630191008662441,0.013899621783463923
0600535,"Airport CDP, California",15,1590,"Airport CDP, California",18,1479,00535,1981,17,3,1,0.2,0.058823529411764705,0.009433962264150943,0.012170385395537525,0.008581524482584554,0.002736423131386582,0.003588860912952971
0600562,"Alameda city, California",4130,72512,"Alameda city, California",5777,78522,00562,76459,5140,1647,637,0.3987893462469734,0.12392996108949417,0.056956090026478376,0.07357173785690635,0.06722557187512261,0.016615647830427974,0.0063461659817837385
0600618,"Alamo CDP, California",65,15177,"Alamo CDP, California",43,14905,00618,12757,74,-22,-31,-0.3384615384615385,-0.4189189189189189,0.004282796336561903,0.002884937940288494,0.005800736850356667,-0.0013978583962734087,-0.002915798910068173
0600674,"Albany city, California",566,17921,"Albany city, California",591,19804,00674,16327,982,25,-391,0.044169611307420496,-0.3981670061099796,0.03158305898108364,0.029842456069480914,0.06014577080908924,-0.0017406029116027281,-0.030303314739608327
0600716,"Albion CDP, California",0,224,"Albion CDP, California",0,254,00716,191,0,0,0,NA,NA,0,0,0,0,0
0600786,"Alderpoint CDP, California",0,210,"Alderpoint CDP, California",0,156,00786,222,1,0,-1,NA,-1,0,0,0.0045045045045045045,0,-0.0045045045045045045
0600884,"Alhambra city, California",1220,83389,"Alhambra city, California",1894,84647,00884,81282,1475,674,419,0.5524590163934426,0.2840677966101695,0.014630227008358417,0.022375276146821506,0.018146699146182426,0.007745049138463089,0.00422857700063908
0600898,"Alhambra Valley CDP, California",0,825,"Alhambra Valley CDP, California",0,783,00898,618,2,0,-2,NA,-1,0,0,0.003236245954692557,0,-0.003236245954692557
0600947,"Aliso Viejo city, California",1473,46329,"Aliso Viejo city, California",1237,50663,00947,7468,117,-236,1120,-0.16021724372029872,9.572649572649572,0.03179434047788642,0.024416240648994336,0.015666845206213177,-0.007378099828892086,0.008749395442781159
0600982,"Alleghany CDP, California",0,53,"Alleghany CDP, California",0,78,00982,68,0,0,0,NA,NA,0,0,0,0,0
0600996,"Allendale CDP, California",0,1726,"Allendale CDP, California",195,1388,00996,1561,49,195,146,NA,2.979591836734694,0,0.14048991354466858,0.03139013452914798,0.14048991354466858,0.10909977901552059
0601010,"Allensworth CDP, California",22,228,"Allensworth CDP, California",15,575,01010,171,35,-7,-20,-0.3181818181818182,-0.5714285714285714,0.09649122807017543,0.02608695652173913,0.2046783625730994,-0.0704042715484363,-0.17859140605136029
0601094,"Almanor CDP, California",0,10,"Almanor CDP, California",0,0,01094,1,0,0,0,NA,NA,0,NA,0,NA,NA
0601150,"Alondra Park CDP, California",1192,8817,"Alondra Park CDP, California",535,8272,01150,8332,978,-657,-443,-0.5511744966442953,-0.45296523517382414,0.13519337643189294,0.06467601547388782,0.11737878060489679,-0.07051736095800512,-0.052702765131008966
0601164,"Alpaugh CDP, California",35,953,"Alpaugh CDP, California",0,1145,01164,633,2,-35,-2,-1,-1,0.03672612801678909,0,0.00315955766192733,-0.03672612801678909,-0.00315955766192733
0601192,"Alpine CDP, California",70,13326,"Alpine CDP, California",271,14878,01192,9695,48,201,223,2.8714285714285714,4.645833333333333,0.005252889088998949,0.0182148138190617,0.004951005673027334,0.012961924730062751,0.013263808146034367
0601228,"Alpine Village CDP, California",0,237,"Alpine Village CDP, California",0,101,01228,115,0,0,0,NA,NA,0,0,0,0,0
0601276,"Alta CDP, California",0,513,"Alta CDP, California",4,566,01276,604,0,4,4,NA,NA,0,0.007067137809187279,0,0.007067137809187279,0.007067137809187279
0601290,"Altadena CDP, California",11873,45446,"Altadena CDP, California",9944,44850,01290,42652,16540,-1929,-6596,-0.16246946854207026,-0.3987908101571947,0.26125511596180084,0.22171683389074692,0.38778955265872644,-0.03953828207105392,-0.16607271876797952
0601360,"Alta Sierra CDP, California",25,7011,"Alta Sierra CDP, California",49,7280,01360,5709,17,24,32,0.96,1.8823529411764706,0.0035658251319355297,0.006730769230769231,0.002977754422841128,0.0031649440988337015,0.003753014807928103
0601416,"Alto CDP, California",0,579,"Alto CDP, California",0,611,01416,652,5,0,-5,NA,-1,0,0,0.007668711656441718,0,-0.007668711656441718
0601444,"Alturas city, California",41,2833,"Alturas city, California",81,2567,01444,3231,13,40,68,0.975609756097561,5.230769230769231,0.01447229085774797,0.031554343591741335,0.004023522129371711,0.017082052733993366,0.027530821462369626
0601458,"Alum Rock CDP, California",209,16049,"Alum Rock CDP, California",168,11551,01458,12533,427,-41,-259,-0.19617224880382775,-0.6065573770491803,0.013022618231665525,0.01454419530776556,0.03407005505465571,0.0015215770761000356,-0.019525859746890153
0601514,"Amador City city, California",0,128,"Amador City city, California",0,167,01514,198,2,0,-2,NA,-1,0,0,0.010101010101010102,0,-0.010101010101010102
0601640,"American Canyon city, California",1157,17692,"American Canyon city, California",1574,20261,01640,7853,460,417,1114,0.36041486603284356,2.4217391304347826,0.06539678950938277,0.07768619515325009,0.058576340252132944,0.012289405643867324,0.01910985490111715
0601651,"Amesti CDP, California",29,3339,"Amesti CDP, California",0,3163,01651,2493,8,-29,-8,-1,-1,0.00868523510032944,0,0.003208985158443642,-0.00868523510032944,-0.003208985158443642
0602000,"Anaheim city, California",8774,333039,"Anaheim city, California",9462,349964,02000,266605,6781,688,2681,0.07841349441531799,0.39536941454062824,0.026345262867111658,0.027037066669714598,0.025434631758594176,6.918038026029402e-4,0.001602434911120422
0602028,"Anchor Bay CDP, California",0,319,"Anchor Bay CDP, California",0,352,02028,272,0,0,0,NA,NA,0,0,0,0,0
0602042,"Anderson city, California",145,9910,"Anderson city, California",167,10407,02042,8303,62,22,105,0.15172413793103448,1.6935483870967742,0.014631685166498487,0.016046891515326223,0.007467180537155245,0.0014152063488277362,0.008579710978170979
0602112,"Angels city, California",0,3790,"Angels city, California",0,3875,02112,2419,6,0,-6,NA,-1,0,0,0.0024803637866887144,0,-0.0024803637866887144
0602168,"Angwin CDP, California",270,3737,"Angwin CDP, California",291,3179,02168,3503,90,21,201,0.07777777777777778,2.2333333333333334,0.07225046829007226,0.09153821956590123,0.02569226377390808,0.019287751275828977,0.06584595579199315
0602210,"Antelope CDP, California",5048,45691,"Antelope CDP, California",4412,48398,02210,14135,1562,-636,2850,-0.1259904912836767,1.824583866837388,0.11048127640016633,0.09116079176825488,0.11050583657587548,-0.019320484631911453,-0.0193450448076206
0602252,"Antioch city, California",16816,99717,"Antioch city, California",23873,111200,02252,62348,1626,7057,22247,0.41965984776403426,13.682041820418204,0.16863724339881866,0.21468525179856116,0.02607942516199397,0.04604800839974249,0.1886058266365672
0602294,"Anza CDP, California",28,2789,"Anza CDP, California",0,3076,02294,1944,12,-28,-12,-1,-1,0.010039440659734672,0,0.006172839506172839,-0.010039440659734672,-0.006172839506172839
0602364,"Apple Valley town, California",7018,67396,"Apple Valley town, California",6437,72726,02364,46154,1801,-581,4636,-0.08278711883727558,2.5741254858411993,0.10413080895008606,0.08851029893023128,0.03902153659487802,-0.015620510019854775,0.049488762335353265
0602378,"Aptos CDP, California",133,6255,"Aptos CDP, California",46,6387,02378,5790,35,-87,11,-0.6541353383458647,0.3142857142857143,0.02126298960831335,0.007202129325191796,0.006044905008635579,-0.014060860283121555,0.001157224316556217
0602382,"Aptos Hills-Larkin Valley CDP, California",0,2384,"Aptos Hills-Larkin Valley CDP, California",0,2251,02382,2205,15,0,-15,NA,-1,0,0,0.006802721088435374,0,-0.006802721088435374
0602420,"Arbuckle CDP, California",0,3206,"Arbuckle CDP, California",56,3809,02420,2053,7,56,49,NA,7,0,0.014702021527960095,0.0034096444227959084,0.014702021527960095,0.011292377105164186
0602462,"Arcadia city, California",528,55704,"Arcadia city, California",1134,58152,02462,48295,374,606,760,1.1477272727272727,2.0320855614973263,0.009478672985781991,0.019500619067271976,0.0077440728853918625,0.010021946081489985,0.011756546181880115
0602476,"Arcata city, California",407,17100,"Arcata city, California",477,18178,02476,15313,185,70,292,0.171990171990172,1.5783783783783785,0.023801169590643274,0.026240510507206515,0.0120812381636518,0.00243934091656324,0.014159272343554715
0602553,"Arden-Arcade CDP, California",7955,90920,"Arden-Arcade CDP, California",10138,102864,02553,88905,3518,2183,6620,0.2744186046511628,1.8817509948834565,0.08749450065992082,0.09855731840099549,0.0395703278780721,0.011062817741074676,0.058986990522923395
0602700,"Armona CDP, California",200,3046,"Armona CDP, California",302,4407,02700,3122,108,102,194,0.51,1.7962962962962963,0.06565988181221274,0.06852734286362605,0.03459320948110186,0.002867461051413306,0.03393413338252419
0602770,"Arnold CDP, California",0,3439,"Arnold CDP, California",0,2291,02770,3865,8,0,-8,NA,-1,0,0,0.002069857697283312,0,-0.002069857697283312
0602812,"Aromas CDP, California",0,2318,"Aromas CDP, California",0,2479,02812,2275,12,0,-12,NA,-1,0,0,0.005274725274725275,0,-0.005274725274725275
0602868,"Arroyo Grande city, California",304,16990,"Arroyo Grande city, California",172,18033,02868,14429,88,-132,84,-0.4342105263157895,0.9545454545454546,0.017892878163625663,0.009538069095547053,0.006098828747660961,-0.00835480906807861,0.003439240347886092
0602896,"Artesia city, California",786,16476,"Artesia city, California",850,16758,02896,15451,412,64,438,0.08142493638676845,1.0631067961165048,0.047705753823743625,0.05072204320324621,0.026664940780532005,0.0030162893795025875,0.024057102422714208
0602910,"Artois CDP, California",0,142,"Artois CDP, California",0,311,02910,207,0,0,0,NA,NA,0,0,0,0,0
0602924,"Arvin city, California",15,18329,"Arvin city, California",124,21249,02924,9346,102,109,22,7.266666666666667,0.21568627450980393,8.183752523323695e-4,0.0058355687326462425,0.01091375989728226,0.005017193480313873,-0.005078191164636017
0602980,"Ashland CDP, California",3565,22098,"Ashland CDP, California",3463,24430,02980,16590,2131,-102,1332,-0.028611500701262272,0.6250586579070859,0.16132681690650738,0.1417519443307409,0.12845087402049427,-0.019574872575766483,0.013301070310246632
0603026,"Aspen Springs CDP, California",0,0,"Aspen Springs CDP, California",0,23,NA,NA,NA,0,NA,NA,NA,NA,0,NA,NA,NA
0603064,"Atascadero city, California",709,27981,"Atascadero city, California",318,30130,03064,23886,442,-391,-124,-0.5514809590973202,-0.28054298642533937,0.02533862263678925,0.01055426485230667,0.01850456334254375,-0.014784357784482581,-0.007950298490237078
0603092,"Atherton town, California",33,6837,"Atherton town, California",62,7168,03092,7163,57,29,5,0.8787878787878788,0.08771929824561403,0.004826678367705134,0.008649553571428572,0.007957559681697613,0.003822875203723438,6.919938897309592e-4
0603162,"Atwater city, California",1185,27587,"Atwater city, California",1124,29296,03162,22475,2077,-61,-953,-0.05147679324894515,-0.4588348579682234,0.0429550150433175,0.038367012561441836,0.09241379310344827,-0.004588002481875665,-0.054046780542006435
0603190,"Auberry CDP, California",10,2212,"Auberry CDP, California",16,2009,03190,1866,0,6,16,0.6,NA,0.0045207956600361665,0.007964161274265804,0,0.003443365614229637,0.007964161274265804
0603204,"Auburn city, California",125,13451,"Auburn city, California",58,14011,03204,10718,65,-67,-7,-0.536,-0.1076923076923077,0.009292989368820162,0.004139604596388552,0.006064564284381415,-0.0051533847724316096,-0.0019249596879928627
0603205,"Auburn Lake Trails CDP, California",58,3953,"Auburn Lake Trails CDP, California",0,3664,03205,2236,1,-58,-1,-1,-1,0.014672400708322793,0,4.472271914132379e-4,-0.014672400708322793,-4.472271914132379e-4
0603209,"August CDP, California",106,8332,"August CDP, California",494,8405,03209,6094,55,388,439,3.660377358490566,7.9818181818181815,0.012722035525684109,0.05877453896490185,0.009025270758122744,0.04605250343921774,0.04974926820677911
0603274,"Avalon city, California",16,3661,"Avalon city, California",4,3731,03274,3013,5,-12,-1,-0.75,-0.2,0.004370390603660202,0.0010720986330742428,0.001659475605708596,-0.003298291970585959,-5.873769726343532e-4
0603302,"Avenal city, California",231,15749,"Avenal city, California",560,12961,03302,9770,1656,329,-1096,1.4242424242424243,-0.6618357487922706,0.014667597942726523,0.04320654270503819,0.16949846468781984,0.028538944762311665,-0.12629192198278166
0603316,"Avery CDP, California",0,381,"Avery CDP, California",0,561,03316,501,0,0,0,NA,NA,0,0,0,0,0
0603330,"Avilla Beach CDP, California",0,1021,"Avila Beach CDP, California",0,1311,03330,947,3,0,-3,NA,-1,0,0,0.0031678986272439284,0,-0.0031678986272439284
0603344,"Avocado Heights CDP, California",163,15473,"Avocado Heights CDP, California",103,15426,03344,14259,120,-60,-17,-0.36809815950920244,-0.14166666666666666,0.010534479415756479,0.006677038765720213,0.008415737428992216,-0.0038574406500362663,-0.0017386986632720036
0603386,"Azusa city, California",1755,46015,"Azusa city, California",1751,49753,03386,40879,1577,-4,174,-0.002279202279202279,0.11033608116677235,0.03813973704226883,0.035193857656824715,0.03857726461019105,-0.0029458793854441126,-0.003383406953366336
0603512,"Baker CDP, California",84,676,"Baker CDP, California",0,541,03512,512,5,-84,-5,-1,-1,0.1242603550295858,0,0.009765625,-0.1242603550295858,-0.009765625
0603526,"Bakersfield city, California",27301,331868,"Bakersfield city, California",28793,377917,03526,185948,18915,1492,9878,0.05465001282004322,0.5222310335712398,0.0822646353369412,0.07618868693390347,0.10172198679200636,-0.006075948403037726,-0.02553329985810289
0603666,"Baldwin Park city, California",633,75387,"Baldwin Park city, California",1166,75892,03666,69315,1687,533,-521,0.8420221169036335,-0.3088322465915827,0.00839667316646106,0.015363938228008222,0.024338166342061603,0.006967265061547162,-0.00897422811405338
0603694,"Ballard CDP, California",0,569,"Ballard CDP, California",0,529,03694,803,0,0,0,NA,NA,0,0,0,0,0
0603708,"Ballico CDP, California",0,431,"Ballico CDP, California",0,538,03708,326,1,0,-1,NA,-1,0,0,0.003067484662576687,0,-0.003067484662576687
0603792,"Bangor CDP, California",0,370,"Bangor CDP, California",0,429,03792,544,19,0,-19,NA,-1,0,0,0.034926470588235295,0,-0.034926470588235295
0603820,"Banning city, California",2006,29030,"Banning city, California",2551,31072,03820,20514,1955,545,596,0.2716849451645065,0.30485933503836316,0.06910093007233896,0.08209963954685891,0.09530077020571318,0.012998709474519948,-0.013201130658854268
0604030,"Barstow city, California",3849,22983,"Barstow city, California",4355,23899,04030,24177,2635,506,1720,0.13146271758898415,0.6527514231499051,0.16747160945046338,0.18222519770701703,0.10898788104396741,0.014753588256553651,0.07323731666304963
0604198,"Bass Lake CDP, California",0,463,"Bass Lake CDP, California",0,449,04198,660,0,0,0,NA,NA,0,0,0,0,0
0604415,"Bay Point CDP, California",2351,21197,"Bay Point CDP, California",2617,25808,04415,17521,2044,266,573,0.113143343258188,0.28033268101761255,0.11091192149832524,0.1014026658400496,0.11666000799041151,-0.009509255658275637,-0.01525734215036191
0604470,"Bayview CDP (Contra Costa County), California",285,2200,"Bayview CDP (Contra Costa County), California",120,1862,04470,1694,142,-165,-22,-0.5789473684210527,-0.15492957746478872,0.12954545454545455,0.0644468313641246,0.08382526564344746,-0.06509862318132995,-0.019378434279322856
0604478,"Bayview CDP (Humboldt County), California",0,2640,"Bayview CDP (Humboldt County), California",31,2811,04478,1318,14,31,17,NA,1.2142857142857142,0,0.011028103877623622,0.010622154779969651,0.011028103877623622,4.059490976539709e-4
0604576,"Beale AFB CDP, California",27,2127,"Beale AFB CDP, California",25,1020,04576,6912,1017,-2,-992,-0.07407407407407407,-0.9754178957718781,0.012693935119887164,0.024509803921568627,0.14713541666666666,0.011815868801681463,-0.12262561274509803
0604632,"Bear Creek CDP, California",0,263,"Bear Creek CDP, California",0,148,04632,509,0,0,0,NA,NA,0,0,0,0,0
0604716,"Bear Valley CDP (Alpine County), California",0,67,"Bear Valley CDP (Alpine County), California",0,59,04716,199,1,0,-1,NA,-1,0,0,0.005025125628140704,0,-0.005025125628140704
0604730,"Bear Valley CDP (Mariposa County), California",0,272,"Bear Valley CDP (Mariposa County), California",0,197,04730,208,0,0,0,NA,NA,0,0,0,0,0
0604734,"Bear Valley Springs CDP, California",21,6011,"Bear Valley Springs CDP, California",66,5292,04734,3105,46,45,20,2.142857142857143,0.43478260869565216,0.00349359507569456,0.012471655328798186,0.014814814814814815,0.008978060253103626,-0.002343159486016629
0604758,"Beaumont city, California",1117,32847,"Beaumont city, California",4280,47144,04758,10289,249,3163,4031,2.8316920322291854,16.188755020080322,0.03400614972448016,0.09078567792295944,0.024200602585285256,0.05677952819847928,0.06658507533767419
0604772,"Beckwourth CDP, California",0,415,"Beckwourth CDP, California",0,414,04772,254,0,0,0,NA,NA,0,0,0,0,0
0604856,"Belden CDP, California",0,78,"Belden CDP, California",0,0,04856,43,0,0,0,NA,NA,0,NA,0,NA,NA
0604870,"Bell city, California",539,35648,"Bell city, California",589,35682,04870,33503,346,50,243,0.09276437847866419,0.7023121387283237,0.015120062836624775,0.01650692225772098,0.010327433364176342,0.0013868594210962055,0.006179488893544638
0604926,"Bella Vista CDP, California",0,2303,"Bella Vista CDP, California",26,2427,04926,2346,9,26,17,NA,1.8888888888888888,0,0.010712814173877214,0.0038363171355498722,0.010712814173877214,0.006876497038327342
0604938,"Bell Canyon CDP, California",0,2457,"Bell Canyon CDP, California",67,2109,04938,1595,28,67,39,NA,1.3928571428571428,0,0.03176861071597914,0.01755485893416928,0.03176861071597914,0.01421375178180986
0663400,"Rutherford CDP, California",0,191,"Rutherford CDP, California",0,88,63400,215,1,0,-1,NA,-1,0,0,0.004651162790697674,0,-0.004651162790697674
0664000,"Sacramento city, California",64413,459511,"Sacramento city, California",66004,500930,64000,369611,56544,1591,9460,0.024699982922701938,0.1673033389926429,0.14017727540798805,0.13176292096700137,0.1529824599376101,-0.008414354440986677,-0.021219538970608715
0664140,"St. Helena city, California",109,5818,"St. Helena city, California",96,6101,64140,4976,22,-13,74,-0.11926605504587157,3.3636363636363638,0.01873496046751461,0.015735125389280447,0.0044212218649517685,-0.0029998350782341615,0.011313903524328678
0664210,"Salida CDP, California",341,14625,"Salida CDP, California",45,14229,64210,4490,56,-296,-11,-0.8680351906158358,-0.19642857142857142,0.023316239316239315,0.0031625553447185324,0.012472160356347439,-0.020153683971520783,-0.009309605011628906
0664224,"Salinas city, California",2659,147074,"Salinas city, California",2354,156143,64224,109010,3276,-305,-922,-0.11470477623166604,-0.28144078144078144,0.01807933421270925,0.015075923992750236,0.030052288780845794,-0.0030034102199590126,-0.014976364788095558
0664252,"Salmon Creek CDP, California",0,83,"Salmon Creek CDP, California",0,20,64252,87,0,0,0,NA,NA,0,0,0,0,0
0664294,"Salton City CDP, California",67,1400,"Salton City CDP, California",156,6250,64294,865,10,89,146,1.328358208955224,14.6,0.047857142857142855,0.02496,0.011560693641618497,-0.022897142857142855,0.013399306358381503
0664308,"Salton Sea Beach CDP, California",0,464,"Salton Sea Beach CDP, California",0,261,64308,467,6,0,-6,NA,-1,0,0,0.01284796573875803,0,-0.01284796573875803
0664392,"Samoa CDP, California",0,273,"Samoa CDP, California",0,212,64392,298,3,0,-3,NA,-1,0,0,0.010067114093959731,0,-0.010067114093959731
0664420,"San Andreas CDP, California",0,2708,"San Andreas CDP, California",8,3120,64420,2334,5,8,3,NA,0.6,0,0.002564102564102564,0.0021422450728363325,0.002564102564102564,4.2185749126623156e-4
0664434,"San Anselmo town, California",118,12203,"San Anselmo town, California",96,12525,64434,11704,96,-22,0,-0.1864406779661017,0,0.009669753339342784,0.007664670658682635,0.008202323991797676,-0.00200508268066015,-5.376533331150415e-4
0664462,"San Antonio Heights CDP, California",15,3979,"San Antonio Heights CDP, California",1,3191,64462,2947,39,-14,-38,-0.9333333333333333,-0.9743589743589743,0.003769791404875597,3.1338138514572234e-4,0.01323379708177808,-0.0034564100197298745,-0.012920415696632357
0664476,"San Ardo CDP, California",0,665,"San Ardo CDP, California",0,543,64476,532,12,0,-12,NA,-1,0,0,0.022556390977443608,0,-0.022556390977443608
0665000,"San Bernardino city, California",33684,209174,"San Bernardino city, California",31000,216089,65000,173702,27558,-2684,3442,-0.07968174801092506,0.12490021046520067,0.16103339803226022,0.1434594079291403,0.15865102301643044,-0.017573990103119913,-0.015191615087290139
0665028,"San Bruno city, California",905,40231,"San Bruno city, California",426,43083,65028,38961,1589,-479,-1163,-0.5292817679558011,-0.7319068596601637,0.02249509085033929,0.009887890815402827,0.04078437411770745,-0.012607200034936464,-0.030896483302304628
0665042,"San Buenaventura (Ventura) city, California",1224,105211,"San Buenaventura (Ventura) city, California",2003,109910,65042,93508,1550,779,453,0.636437908496732,0.292258064516129,0.011633764530324777,0.01822400145573651,0.016576121829148308,0.006590236925411734,0.0016478796265882029
0665070,"San Carlos city, California",130,27830,"San Carlos city, California",248,30154,65070,26573,250,118,-2,0.9076923076923077,-0.008,0.004671218109953288,0.008224447834449825,0.00940804576073458,0.0035532297244965363,-0.0011835979262847553
0665084,"San Clemente city, California",390,60774,"San Clemente city, California",504,64878,65084,41087,274,114,230,0.2923076923076923,0.8394160583941606,0.006417217889228947,0.0077684268935540556,0.006668776011877236,0.0013512090043251088,0.0010996508816768199
0665112,"Sand City city, California",13,234,"Sand City city, California",15,310,65112,192,11,2,4,0.15384615384615385,0.36363636363636365,0.05555555555555555,0.04838709677419355,0.057291666666666664,-0.007168458781362005,-0.008904569892473117
0666000,"San Diego city, California",86240,1282800,"San Diego city, California",90095,1409573,66000,1110572,104261,3855,-14166,0.044700834879406307,-0.13587055562482617,0.06722793888369193,0.06391651939984662,0.0938804507947256,-0.003311419483845307,-0.029963931394878976
0666004,"San Diego Country Estates CDP, California",34,10657,"San Diego Country Estates CDP, California",66,10514,66004,7326,48,32,18,0.9411764705882353,0.375,0.003190391292108473,0.006277344493056876,0.006552006552006552,0.0030869532009484032,-2.7466205894967604e-4
0666070,"San Dimas city, California",752,33635,"San Dimas city, California",656,34048,66070,32397,1221,-96,-565,-0.1276595744680851,-0.46273546273546273,0.02235766314850602,0.01926691729323308,0.03768867487730346,-0.003090745855272938,-0.018421757584070376
0666140,"San Fernando city, California",44,23623,"San Fernando city, California",209,24535,66140,22542,266,165,-57,3.75,-0.21428571428571427,0.0018625915421411337,0.00851844304055431,0.011800195191198652,0.006655851498413177,-0.0032817521506443414
0667000,"San Francisco city, California",49071,789172,"San Francisco city, California",45556,874961,67000,723959,79039,-3515,-33483,-0.07163090216217317,-0.4236263110616278,0.0621803611886889,0.05206632067029273,0.10917607212563142,-0.010114040518396171,-0.05710975145533869
0667042,"San Gabriel city, California",286,39670,"San Gabriel city, California",268,40143,67042,37089,394,-18,-126,-0.06293706293706294,-0.3197969543147208,0.007209478195109655,0.0066761328251500884,0.010623095796597374,-5.333453699595666e-4,-0.0039469629714472855
0667056,"Sanger city, California",546,23370,"Sanger city, California",25,25074,67056,16906,18,-521,7,-0.9542124542124543,0.3888888888888889,0.02336328626444159,9.97048735742203e-4,0.0010647107535786111,-0.022366237528699387,-6.766201783640815e-5
0667070,"San Geronimo CDP, California",0,562,"San Geronimo CDP, California",0,399,67070,375,1,0,-1,NA,-1,0,0,0.0026666666666666666,0,-0.0026666666666666666
0667112,"San Jacinto city, California",2095,41203,"San Jacinto city, California",3640,47989,67112,17625,193,1545,3447,0.7374701670644391,17.860103626943005,0.05084581219814091,0.07585071578903499,0.010950354609929078,0.02500490359089408,0.06490036117910591
0667126,"San Joaquin city, California",0,3927,"San Joaquin city, California",48,4020,67126,2311,14,48,34,NA,2.4285714285714284,0,0.011940298507462687,0.006057983556901774,0.011940298507462687,0.0058823149505609126
0668000,"San Jose city, California",28019,925300,"San Jose city, California",30813,1027690,68000,792266,37005,2794,-6192,0.0997180484671116,-0.167328739359546,0.030280989949205663,0.029982776907433176,0.04670779763362305,-2.982130417724868e-4,-0.016725020726189876
0668014,"San Juan Bautista city, California",64,1462,"San Juan Bautista city, California",4,2019,68014,1624,8,-60,-4,-0.9375,-0.5,0.04377564979480164,0.001981178801386825,0.0049261083743842365,-0.041794470993414816,-0.0029449295729974114
0668028,"San Juan Capistrano city, California",204,34263,"San Juan Capistrano city, California",176,35922,68028,26183,95,-28,81,-0.13725490196078433,0.8526315789473684,0.005953944488223448,0.0048995044819330775,0.003628308444410495,-0.0010544400062903704,0.0012711960375225823
0668084,"San Leandro city, California",10579,82830,"San Leandro city, California",9238,90025,68084,68223,3923,-1341,5315,-0.1267605633802817,1.3548304868722916,0.12771942532898709,0.10261594001666204,0.057502601761869165,-0.02510348531232505,0.04511333825479287
0668112,"San Lorenzo CDP, California",1559,23562,"San Lorenzo CDP, California",769,25569,68112,19987,249,-790,520,-0.5067350865939705,2.0883534136546187,0.06616586028350734,0.030075482029019517,0.012458097763546306,-0.03609037825448782,0.017617384265473213
0668140,"San Lucas CDP, California",9,191,"San Lucas CDP, California",0,543,68140,432,0,-9,0,-1,NA,0.04712041884816754,0,0,-0.04712041884816754,0
0668154,"San Luis Obispo city, California",792,44959,"San Luis Obispo city, California",998,47302,68154,42155,797,206,201,0.2601010101010101,0.2521957340025094,0.017616050179052024,0.02109847363747833,0.018906416795160717,0.0034824234584263057,0.0021920568423176127
0668196,"San Marcos city, California",1910,78127,"San Marcos city, California",2591,95355,68196,39015,567,681,2024,0.3565445026178011,3.569664902998236,0.024447374147221833,0.027172146190551097,0.01453287197231834,0.002724772043329264,0.012639274218232757
0668224,"San Marino city, California",0,13114,"San Marino city, California",246,13194,68224,12989,32,246,214,NA,6.6875,0,0.018644838562983174,0.0024636230656709525,0.018644838562983174,0.01618121549731222
0668238,"San Martin CDP, California",42,7250,"San Martin CDP, California",70,6803,68238,6950,81,28,-11,0.6666666666666666,-0.13580246913580246,0.005793103448275862,0.010289578127296781,0.011654676258992806,0.00449647467902092,-0.0013650981316960242
0668252,"San Mateo city, California",2262,94751,"San Mateo city, California",2044,104333,68252,85486,3060,-218,-1016,-0.09637488947833775,-0.33202614379084966,0.023873098964654726,0.01959111690452685,0.03579533490864001,-0.004281982060127875,-0.016204218004113157
0668263,"San Miguel CDP (Contra Costa County), California",33,3381,"San Miguel CDP (Contra Costa County), California",20,3433,68263,3248,7,-13,13,-0.3939393939393939,1.8571428571428572,0.009760425909494233,0.005825808330905913,0.0021551724137931034,-0.00393461757858832,0.0036706359171128095
0668266,"San Miguel CDP (San Luis Obispo County), California",0,2695,"San Miguel CDP (San Luis Obispo County), California",0,2906,68266,1222,38,0,-38,NA,-1,0,0,0.031096563011456628,0,-0.031096563011456628
0668294,"San Pablo city, California",3988,29136,"San Pablo city, California",3511,30967,68294,25126,5368,-477,-1857,-0.11960882647943831,-0.34593889716840537,0.1368753432180121,0.11337875803274454,0.2136432380800764,-0.02349658518526755,-0.10026448004733186
0668308,"San Pasqual CDP, California",48,2052,"San Pasqual CDP, California",93,1970,68308,2097,88,45,5,0.9375,0.056818181818181816,0.023391812865497075,0.047208121827411166,0.04196471149260849,0.02381630896191409,0.005243410334802676
0668364,"San Rafael city, California",1609,56930,"San Rafael city, California",807,58775,68364,48340,1424,-802,-617,-0.49844623990055936,-0.4332865168539326,0.028262778851220798,0.013730327520204168,0.02945800579230451,-0.014532451331016629,-0.01572767827210034
0668378,"San Ramon city, California",1622,66822,"San Ramon city, California",1767,75648,68378,35349,711,145,1056,0.08939580764488286,1.4852320675105486,0.02427344287809404,0.02335818527918782,0.020113723160485444,-9.152575989062224e-4,0.0032444621187023744
0668434,"San Simeon CDP, California",0,547,"San Simeon CDP, California",0,658,68434,374,1,0,-1,NA,-1,0,0,0.00267379679144385,0,-0.00267379679144385
0669000,"Santa Ana city, California",4199,325216,"Santa Ana city, California",3803,332794,69000,294070,7691,-396,-3888,-0.09430816861157418,-0.5055259394096997,0.012911418872380202,0.011427489678299489,0.026153636889176046,-0.0014839291940807135,-0.014726147210876558
0669070,"Santa Barbara city, California",1471,87859,"Santa Barbara city, California",1413,91376,69070,85787,1920,-58,-507,-0.03942895989123046,-0.2640625,0.016742735519411786,0.015463579057958326,0.022381013440264844,-0.0012791564614534606,-0.006917434382306518
0669084,"Santa Clara city, California",2939,112466,"Santa Clara city, California",3780,127721,69084,93856,2411,841,1369,0.28615175229669954,0.5678141849854832,0.02613234221898174,0.029595759507050526,0.025688288441868393,0.0034634172880687875,0.003907471065182133
0669088,"Santa Clarita city, California",4327,172253,"Santa Clarita city, California",8394,213411,69088,124153,1942,4067,6452,0.9399121793390339,3.322348094747683,0.02512002693712156,0.03933255549151637,0.015641990125087595,0.014212528554394806,0.023690565366428773
0669112,"Santa Cruz city, California",772,58269,"Santa Cruz city, California",1349,64522,69112,48986,1126,577,223,0.7474093264248705,0.1980461811722913,0.013248897355369065,0.020907597408635813,0.0229861593108235,0.007658700053266748,-0.0020785619021876887
0669154,"Santa Fe Springs city, California",586,16376,"Santa Fe Springs city, California",715,17810,69154,15435,311,129,404,0.22013651877133106,1.2990353697749195,0.03578407425500733,0.040145985401459854,0.02014901198574668,0.004361911146452527,0.019996973415713173
0669182,"Santa Margarita CDP, California",0,1431,"Santa Margarita CDP, California",0,1122,69182,1267,1,0,-1,NA,-1,0,0,7.892659826361484e-4,0,-7.892659826361484e-4
0669196,"Santa Maria city, California",1806,94645,"Santa Maria city, California",1345,106224,69196,62605,1361,-461,-16,-0.2552602436323367,-0.011756061719324026,0.019081832109461672,0.012661921976201236,0.021739477677501798,-0.0064199101332604366,-0.009077555701300562
0670000,"Santa Monica city, California",3693,88679,"Santa Monica city, California",4100,91577,70000,86905,3920,407,180,0.11020850257243434,0.04591836734693878,0.0416445832722516,0.04477106697096433,0.045106725734997986,0.003126483698712726,-3.3565876403365835e-4
0670028,"Santa Nella CDP, California",50,1262,"Santa Nella CDP, California",35,2135,70028,628,5,-15,30,-0.3,6,0.039619651347068144,0.01639344262295082,0.007961783439490446,-0.023226208724117323,0.008431659183460375
0670042,"Santa Paula city, California",35,29145,"Santa Paula city, California",101,30098,70042,25185,78,66,23,1.8857142857142857,0.2948717948717949,0.001200892091267799,0.003355704697986577,0.003097081596188207,0.0021548126067187784,2.5862310179837e-4
0670098,"Santa Rosa city, California",3497,162647,"Santa Rosa city, California",4757,179701,70098,122374,2251,1260,2506,0.3603088361452674,1.113282985339849,0.021500550271446754,0.026471750296325564,0.01839443018941932,0.004971200024878809,0.008077320106906243
0670130,"Santa Rosa Valley CDP, California",0,3223,"Santa Rosa Valley CDP, California",21,3016,70130,2907,21,21,0,NA,0,0,0.006962864721485411,0.007223942208462332,0.006962864721485411,-2.610774869769208e-4
0670140,"Santa Susana CDP, California",41,1301,"Santa Susana CDP, California",3,935,70140,903,12,-38,-9,-0.926829268292683,-0.75,0.03151421983089931,0.0032085561497326204,0.013289036544850499,-0.02830566368116669,-0.010080480395117879
0670154,"Santa Venetia CDP, California",30,5102,"Santa Venetia CDP, California",165,4474,70154,4006,97,135,68,4.5,0.7010309278350515,0.005880047040376323,0.036879749664729546,0.024213679480778832,0.030999702624353222,0.012666070183950714
0670182,"Santa Ynez CDP, California",19,4862,"Santa Ynez CDP, California",1,4546,70182,4215,3,-18,-2,-0.9473684210526315,-0.6666666666666666,0.00390785684903332,2.199736031676199e-4,7.117437722419929e-4,-0.0036878832458656996,-4.917701690743731e-4
0670224,"Santee city, California",702,52966,"Santee city, California",1305,57797,70224,52902,893,603,412,0.8589743589743589,0.46136618141097424,0.013253785447268058,0.022579026593075764,0.016880269176968735,0.009325241145807706,0.0056987574161070295
0670266,"Saranap CDP, California",279,4920,"Saranap CDP, California",135,6231,70266,4568,18,-144,117,-0.5161290322580645,6.5,0.056707317073170734,0.021665864227250843,0.00394045534150613,-0.03504145284591989,0.017725408885744712
0670280,"Saratoga city, California",85,29523,"Saratoga city, California",140,30697,70280,28224,119,55,21,0.6470588235294118,0.17647058823529413,0.0028791112014361683,0.004560706257940516,0.004216269841269841,0.0016815950565043473,3.444364166706746e-4
0670322,"Saticoy CDP, California",0,905,"Saticoy CDP, California",6,1242,70322,1059,4,6,2,NA,0.5,0,0.004830917874396135,0.003777148253068933,0.004830917874396135,0.001053769621327202
0670336,"Sattley CDP, California",0,22,"Sattley CDP, California",0,86,70336,55,0,0,0,NA,NA,0,0,0,0,0
0670364,"Sausalito city, California",0,7009,"Sausalito city, California",61,7116,70364,6984,70,61,-9,NA,-0.12857142857142856,0,0.008572231590781338,0.01002290950744559,0.008572231590781338,-0.0014506779166642524
0670518,"Scotia CDP, California",0,652,"Scotia CDP, California",0,546,70518,927,0,0,0,NA,NA,0,0,0,0,0
0670588,"Scotts Valley city, California",60,11351,"Scotts Valley city, California",71,11863,70588,8622,41,11,30,0.18333333333333332,0.7317073170731707,0.005285877896220597,0.005984995363735986,0.004755277197865925,6.991174675153883e-4,0.001229718165870061
0670644,"Seacliff CDP, California",52,2990,"Seacliff CDP, California",22,3286,70644,3134,32,-30,-10,-0.5769230769230769,-0.3125,0.017391304347826087,0.006695069993913573,0.01021059349074665,-0.010696234353912515,-0.0035155234968330777
0670686,"Seal Beach city, California",153,24081,"Seal Beach city, California",562,24204,70686,25051,245,409,317,2.673202614379085,1.2938775510204081,0.0063535567459823096,0.02321930259461246,0.009780048700650672,0.01686574584863015,0.013439253893961788
0670712,"Sea Ranch CDP, California",0,801,"Sea Ranch CDP, California",0,1134,70712,637,1,0,-1,NA,-1,0,0,0.0015698587127158557,0,-0.0015698587127158557
0670728,"Searles Valley CDP, California",9,2088,"Searles Valley CDP, California",101,1689,70728,2740,20,92,81,10.222222222222221,4.05,0.004310344827586207,0.05979869745411486,0.0072992700729927005,0.05548835262652865,0.05249942738112216
0670742,"Seaside city, California",3107,32431,"Seaside city, California",2479,33956,70742,38901,9129,-628,-6650,-0.20212423559703893,-0.7284478037024866,0.09580339798341093,0.07300624337377783,0.23467263052363693,-0.022797154609633108,-0.1616663871498591
0670770,"Sebastopol city, California",69,7335,"Sebastopol city, California",123,7760,70770,7082,26,54,97,0.782608695652174,3.730769230769231,0.009406952965235174,0.015850515463917525,0.0036712792996328723,0.0064435624986823505,0.012179236164284653
0670798,"Seeley CDP, California",30,1861,"Seeley CDP, California",27,2010,70798,1228,11,-3,16,-0.1,1.4545454545454546,0.016120365394948953,0.013432835820895522,0.008957654723127036,-0.002687529574053431,0.004475181097768486
0670882,"Selma city, California",374,22617,"Selma city, California",83,24675,70882,15062,205,-291,-122,-0.7780748663101604,-0.5951219512195122,0.016536233806428793,0.0033637284701114488,0.013610410304076484,-0.013172505336317343,-0.010246681833965036
0670966,"Sequoia Crest CDP, California",0,0,"Sequoia Crest CDP, California",0,38,70966,59,0,0,0,NA,NA,NA,0,0,NA,0
0671000,"Sereno del Mar CDP, California",0,123,"Sereno del Mar CDP, California",0,80,71000,121,4,0,-4,NA,-1,0,0,0.03305785123966942,0,-0.03305785123966942
0671078,"Seville CDP, California",0,646,"Seville CDP, California",0,614,71078,443,6,0,-6,NA,-1,0,0,0.013544018058690745,0,-0.013544018058690745
0671084,"Shackelford CDP, California",243,3748,NA,NA,NA,71084,3650,19,NA,NA,NA,NA,0.06483457844183564,NA,0.0052054794520547945,NA,NA
0671106,"Shafter city, California",117,16378,"Shafter city, California",409,19447,71106,9934,40,292,369,2.4957264957264957,9.225,0.007143729393088289,0.02103152157145061,0.004026575397624321,0.013887792178362321,0.01700494617382629
0671134,"Shandon CDP, California",115,939,"Shandon CDP, California",11,1085,71134,784,2,-104,9,-0.9043478260869565,4.5,0.12247071352502663,0.010138248847926268,0.002551020408163265,-0.11233246467710035,0.0075872284397630035
0671218,"Shasta CDP, California",0,1572,"Shasta CDP, California",20,1573,71218,1439,2,20,18,NA,9,0,0.012714558169103624,0.001389854065323141,0.012714558169103624,0.011324704103780484
0671225,"Shasta Lake city, California",48,10081,"Shasta Lake city, California",133,10206,71225,8726,32,85,101,1.7708333333333333,3.15625,0.004761432397579605,0.013031550068587106,0.003667201466880587,0.0082701176710075,0.00936434860170652
0671246,"Shaver Lake CDP, California",0,708,"Shaver Lake CDP, California",0,473,71246,609,0,0,0,NA,NA,0,0,0,0,0
0671362,"Shell Ridge CDP, California",0,1381,"Shell Ridge CDP, California",51,1342,71362,975,8,51,43,NA,5.375,0,0.038002980625931444,0.008205128205128205,0.038002980625931444,0.02979785242080324
0671372,"Shelter Cove CDP, California",0,524,"Shelter Cove CDP, California",0,580,71372,214,0,0,0,NA,NA,0,0,0,0,0
0671414,"Sheridan CDP, California",0,1615,"Sheridan CDP, California",0,1355,71414,1366,3,0,-3,NA,-1,0,0,0.0021961932650073207,0,-0.0021961932650073207
0671554,"Shingle Springs CDP, California",27,3926,"Shingle Springs CDP, California",37,3846,71554,3837,19,10,18,0.37037037037037035,0.9473684210526315,0.006877228731533368,0.009620384815392615,0.0049517852488923635,0.0027431560838592477,0.004668599566500252
0671568,"Shingletown CDP, California",35,2084,"Shingletown CDP, California",22,2246,71568,1926,0,-13,22,-0.37142857142857144,NA,0.016794625719769675,0.009795191451469279,0,-0.006999434268300396,0.009795191451469279
0671680,"Shoshone CDP, California",0,33,"Shoshone CDP, California",0,17,71680,79,0,0,0,NA,NA,0,0,0,0,0
0671774,"Sierra Brooks CDP, California",0,210,"Sierra Brooks CDP, California",0,292,71774,282,0,0,0,NA,NA,0,0,0,0,0
0671778,"Sierra City CDP, California",0,601,"Sierra City CDP, California",0,126,71778,328,0,0,0,NA,NA,0,0,0,0,0
0671806,"Sierra Madre city, California",198,10854,"Sierra Madre city, California",112,10932,71806,10762,92,-86,20,-0.43434343434343436,0.21739130434782608,0.01824212271973466,0.010245151847786316,0.008548596915071548,-0.007996970871948344,0.0016965549327147677
0671834,"Sierra Village CDP, California",0,152,"Sierra Village CDP, California",0,169,71834,476,1,0,-1,NA,-1,0,0,0.0021008403361344537,0,-0.0021008403361344537
0671848,"Sierraville CDP, California",11,250,"Sierraville CDP, California",1,85,71848,275,0,-10,1,-0.9090909090909091,NA,0.044,0.011764705882352941,0,-0.032235294117647056,0.011764705882352941
0671876,"Signal Hill city, California",1395,10700,"Signal Hill city, California",1287,11512,71876,8369,884,-108,403,-0.07741935483870968,0.45588235294117646,0.13037383177570094,0.11179638637943017,0.10562791253435297,-0.018577445396270778,0.006168473845077196
0671927,"Silverado Resort CDP, California",0,1244,"Silverado Resort CDP, California",13,1018,71927,1322,24,13,-11,NA,-0.4583333333333333,0,0.012770137524557957,0.018154311649016642,0.012770137524557957,-0.005384174124458685
0671932,"Silver City CDP, California",0,0,"Silver City CDP, California",0,0,71932,0,0,0,0,NA,NA,NA,NA,NA,NA,NA
0671964,"Silver Lakes CDP, California",134,3860,"Silver Lakes CDP, California",478,5849,71964,2851,61,344,417,2.5671641791044775,6.836065573770492,0.03471502590673575,0.08172337151649854,0.021396001403016486,0.04700834560976279,0.060327370113482055
0672016,"Simi Valley city, California",1377,121662,"Simi Valley city, California",1637,125842,72016,100420,1528,260,109,0.1888162672476398,0.07133507853403141,0.011318242343541944,0.013008375582079115,0.015216092411870146,0.0016901332385371708,-0.0022077168297910312
0672086,"Sisquoc CDP, California",0,165,"Sisquoc CDP, California",0,169,72086,333,3,0,-3,NA,-1,0,0,0.009009009009009009,0,-0.009009009009009009
0672156,"Sky Valley CDP, California",0,1838,"Sky Valley CDP, California",118,2227,72156,847,3,118,115,NA,38.333333333333336,0,0.05298607992815447,0.0035419126328217238,0.05298607992815447,0.04944416729533274
0672184,"Sleepy Hollow CDP, California",0,2443,"Sleepy Hollow CDP, California",0,2273,72184,2227,11,0,-11,NA,-1,0,0,0.004939380332285586,0,-0.004939380332285586
0672282,"Smartsville CDP, California",0,221,"Smartsville CDP, California",8,267,72282,190,0,8,8,NA,NA,0,0.0299625468164794,0,0.0299625468164794,0.0299625468164794
0672338,"Smith Corner CDP, California",0,287,"Smith Corner CDP, California",0,486,72338,584,0,0,0,NA,NA,0,0,0,0,0
0672380,"Smith River CDP, California",0,1050,"Smith River CDP, California",0,498,72380,790,1,0,-1,NA,-1,0,0,0.0012658227848101266,0,-0.0012658227848101266
0672408,"Snelling CDP, California",0,141,"Snelling CDP, California",0,119,72408,329,0,0,0,NA,NA,0,0,0,0,0
0672478,"Soda Bay CDP, California",8,945,"Soda Bay CDP, California",0,878,72478,698,19,-8,-19,-1,-1,0.008465608465608466,0,0.027220630372492838,-0.008465608465608466,-0.027220630372492838
0672492,"Soda Springs CDP, California",0,128,"Soda Springs CDP, California",0,46,72492,99,0,0,0,NA,NA,0,0,0,0,0
0672506,"Solana Beach city, California",345,12790,"Solana Beach city, California",96,13356,72506,12967,61,-249,35,-0.7217391304347827,0.5737704918032787,0.02697419859265051,0.0071877807726864335,0.0047042492480913085,-0.019786417819964076,0.002483531524595125
0672520,"Soledad city, California",2899,25350,"Soledad city, California",2464,25705,72520,13688,2239,-435,225,-0.1500517419799931,0.10049129075480125,0.11435897435897435,0.09585683719120794,0.1635739333722969,-0.018502137167766414,-0.06771709618108895
0672576,"Solvang city, California",0,5218,"Solvang city, California",68,5804,72576,4751,14,68,54,NA,3.857142857142857,0,0.01171605789110958,0.002946748053041465,0.01171605789110958,0.008769309838068116
0672646,"Sonoma city, California",33,10292,"Sonoma city, California",36,11075,72646,8400,28,3,8,0.09090909090909091,0.2857142857142857,0.0032063738826272835,0.0032505643340857786,0.0033333333333333335,4.4190451458495095e-5,-8.276899924755492e-5
0672674,"Sonora city, California",12,4914,"Sonora city, California",58,4844,72674,4369,9,46,49,3.8333333333333335,5.444444444444445,0.002442002442002442,0.011973575557390587,0.002059967956054017,0.009531573115388145,0.00991360760133657
0672688,"Soquel CDP, California",0,9392,"Soquel CDP, California",32,10883,72688,9181,48,32,-16,NA,-0.3333333333333333,0,0.0029403657079849306,0.005228188650473805,0.0029403657079849306,-0.0022878229424888744
0672772,"Soulsbyville CDP, California",0,2031,"Soulsbyville CDP, California",0,2216,72772,1732,4,0,-4,NA,-1,0,0,0.0023094688221709007,0,-0.0023094688221709007
0672954,"South Dos Palos CDP, California",28,2271,"South Dos Palos CDP, California",128,1756,72954,1244,352,100,-224,3.5714285714285716,-0.6363636363636364,0.012329370321444297,0.07289293849658314,0.2829581993569132,0.060563568175138846,-0.21006526086033006
0672996,"South El Monte city, California",35,20240,"South El Monte city, California",75,20721,72996,20715,102,40,-27,1.1428571428571428,-0.2647058823529412,0.0017292490118577075,0.003619516432604604,0.004923968139029689,0.0018902674207468967,-0.0013044517064250845
0673080,"South Gate city, California",494,94683,"South Gate city, California",646,94642,73080,86284,1437,152,-791,0.3076923076923077,-0.5504523312456506,0.005217409672274854,0.006825722195219881,0.016654304390153446,0.0016083125229450273,-0.009828582194933565
0673108,"South Lake Tahoe city, California",94,22114,"South Lake Tahoe city, California",237,21939,73108,21589,223,143,14,1.5212765957446808,0.06278026905829596,0.004250700913448494,0.010802680158621633,0.010329334383250729,0.006551979245173139,4.7334577537090465e-4
0673167,"South Monrovia Island CDP, California",468,6443,"South Monrovia Island CDP, California",598,6572,73167,5904,1413,130,-815,0.2777777777777778,-0.5767869780608634,0.07263697035542449,0.09099208764455265,0.23932926829268292,0.018355117289128156,-0.14833718064813028
0673178,"South Oroville CDP, California",730,6688,"South Oroville CDP, California",10,2906,73178,5606,473,-720,-463,-0.9863013698630136,-0.9788583509513742,0.10915071770334928,0.0034411562284927736,0.08437388512308241,-0.10570956147485651,-0.08093272889458965
0673220,"South Pasadena city, California",591,25376,"South Pasadena city, California",922,25661,73220,23936,745,331,177,0.560067681895093,0.23758389261744967,0.02328972257250946,0.035930010521803515,0.03112466577540107,0.012640287949294057,0.004805344746402446
0673262,"South San Francisco city, California",1691,62016,"South San Francisco city, California",1243,67408,73262,54342,2172,-448,-929,-0.26493199290360736,-0.42771639042357273,0.0272671568627451,0.01843994778067885,0.03996908468587833,-0.008827209082066249,-0.02152913690519948
0673276,"South San Gabriel CDP, California",8,8136,"South San Gabriel CDP, California",18,8138,73276,7653,49,10,-31,1.25,-0.6326530612244898,9.832841691248771e-4,0.0022118456623248955,0.006402717888409774,0.0012285614932000183,-0.004190872226084878
0673290,"South San Jose Hills CDP, California",97,21379,"South San Jose Hills CDP, California",166,19977,73290,18317,433,69,-267,0.711340206185567,-0.6166281755196305,0.004537162636231816,0.008309555989387795,0.023639242233990283,0.003772393353155979,-0.015329686244602488
0673388,"South Taft CDP, California",0,2177,"South Taft CDP, California",12,1768,73388,2170,4,12,8,NA,2,0,0.006787330316742082,0.0018433179723502304,0.006787330316742082,0.004944012344391851
0673430,"South Whittier CDP, California",354,56882,"South Whittier CDP, California",562,60357,73430,49616,589,208,-27,0.5875706214689266,-0.04584040747028863,0.006223409866038466,0.00931126464204649,0.011871170590132216,0.0030878547760080245,-0.0025599059480857257
0673554,"Spaulding CDP, California",0,172,"Spaulding CDP, California",0,108,73554,201,0,0,0,NA,NA,0,0,0,0,0
0673612,"Spreckels CDP, California",11,621,"Spreckels CDP, California",0,414,73612,571,0,-11,0,-1,NA,0.017713365539452495,0,0,-0.017713365539452495,0
0673654,"Spring Garden CDP, California",0,0,"Spring Garden CDP, California",0,20,73654,28,0,0,0,NA,NA,NA,0,0,NA,0
0673690,"Spring Valley CDP (Lake County), California",30,822,"Spring Valley CDP (Lake County), California",47,1094,73690,466,16,17,31,0.5666666666666667,1.9375,0.0364963503649635,0.04296160877513711,0.034334763948497854,0.006465258410173612,0.008626844826639259
0673696,"Spring Valley CDP (San Diego County), California",2895,27300,"Spring Valley CDP (San Diego County), California",4539,31650,73696,24699,1353,1644,3186,0.5678756476683938,2.354767184035477,0.10604395604395604,0.14341232227488152,0.05477954573059638,0.03736836623092547,0.08863277654428514
0673700,"Spring Valley Lake CDP, California",21,7640,"Spring Valley Lake CDP, California",445,8403,73700,5408,146,424,299,20.19047619047619,2.047945205479452,0.00274869109947644,0.052957277162918,0.026997041420118342,0.050208586063441564,0.02596023574279966
0673710,"Springville CDP, California",0,1269,"Springville CDP, California",0,965,73710,1121,0,0,0,NA,NA,0,0,0,0,0
0673794,"Squaw Valley CDP, California",0,2435,"Squaw Valley CDP, California",44,3646,73794,2161,38,44,6,NA,0.15789473684210525,0,0.012068019747668678,0.017584451642757983,0.012068019747668678,-0.005516431895089305
0673815,"Squirrel Mountain Valley CDP, California",0,662,"Squirrel Mountain Valley CDP, California",0,981,73815,532,2,0,-2,NA,-1,0,0,0.0037593984962406013,0,-0.0037593984962406013
0673868,"Stallion Springs CDP, California",0,2454,"Stallion Springs CDP, California",0,3581,73868,705,5,0,-5,NA,-1,0,0,0.0070921985815602835,0,-0.0070921985815602835
0673906,"Stanford CDP, California",673,14256,"Stanford CDP, California",618,16326,73906,18097,961,-55,-343,-0.08172362555720654,-0.35691987513007284,0.047208193041526375,0.037853730246233,0.05310272420843234,-0.009354462795293374,-0.015248993962199336
0673962,"Stanton city, California",959,37990,"Stanton city, California",460,38377,73962,30504,692,-499,-232,-0.5203336809176226,-0.3352601156069364,0.025243485127665177,0.011986345988482685,0.022685549436139523,-0.013257139139182491,-0.010699203447656838
0674130,"Stevenson Ranch CDP, California",611,16934,"Stevenson Ranch CDP, California",685,19179,74130,1638,12,74,673,0.12111292962356793,56.083333333333336,0.03608125664343923,0.03571614787006622,0.007326007326007326,-3.6510877337301434e-4,0.02839014054405889
0674144,"Stevinson CDP, California",0,239,"Stevinson CDP, California",0,177,74144,216,6,0,-6,NA,-1,0,0,0.027777777777777776,0,-0.027777777777777776
0674172,"Stinson Beach CDP, California",0,446,"Stinson Beach CDP, California",0,600,74172,814,9,0,-9,NA,-1,0,0,0.011056511056511056,0,-0.011056511056511056
0674186,"Stirling City CDP, California",0,277,"Stirling City CDP, California",0,374,74186,284,0,0,0,NA,NA,0,0,0,0,0
0675000,"Stockton city, California",34471,287377,"Stockton city, California",34481,309228,75000,211782,20384,10,14097,2.9009892373299296e-4,0.6915718210361067,0.1199504483657356,0.11150671996067626,0.0962499173678594,-0.0084437284050593309,0.015256802592816865
0675154,"Stonyford CDP, California",0,119,"Stonyford CDP, California",0,92,75154,183,3,0,-3,NA,-1,0,0,0.01639344262295082,0,-0.01639344262295082
0675168,"Storrie CDP, California",0,0,"Storrie CDP, California",0,0,75168,32,0,0,0,NA,NA,NA,NA,0,NA,NA
0675252,"Stratford CDP, California",11,1301,"Stratford CDP, California",0,901,75252,718,12,-11,-12,-1,-1,0.008455034588777863,0,0.016713091922005572,-0.008455034588777863,-0.016713091922005572
0675280,"Strathmore CDP, California",0,3298,"Strathmore CDP, California",0,3033,75280,2353,2,0,-2,NA,-1,0,0,8.499787505312367e-4,0,-8.499787505312367e-4
0675315,"Strawberry CDP (Marin County), California",210,5138,"Strawberry CDP (Marin County), California",65,5527,75315,4212,101,-145,-36,-0.6904761904761905,-0.3564356435643564,0.04087193460490463,0.011760448706350643,0.023979107312440646,-0.029111485898553988,-0.012218658606090003
0675322,"Strawberry CDP (Tuolumne County), California",0,64,"Strawberry CDP (Tuolumne County), California",0,5,75322,116,0,0,0,NA,NA,0,0,0,0,0
0675588,"Sugarloaf Mountain Park CDP, California",0,0,"Sugarloaf Mountain Park CDP, California",0,0,NA,NA,NA,0,NA,NA,NA,NA,NA,NA,NA,NA
0675592,"Sugarloaf Saw Mill CDP, California",0,0,"Sugarloaf Saw Mill CDP, California",0,0,NA,NA,NA,0,NA,NA,NA,NA,NA,NA,NA,NA
0675596,"Sugarloaf Village CDP, California",0,17,"Sugarloaf Village CDP, California",0,9,NA,NA,NA,0,NA,NA,NA,0,0,NA,0,NA
0675630,"Suisun City city, California",5883,27742,"Suisun City city, California",6212,29488,75630,22726,3236,329,2976,0.05592384837667857,0.9196538936959209,0.2120611347415471,0.21066196418882258,0.14239197395054123,-0.001399170552724538,0.06826999023828134
0675672,"Sultana CDP, California",0,442,"Sultana CDP, California",0,1002,75672,808,0,0,0,NA,NA,0,0,0,0,0
0675714,"Summerland CDP, California",0,1083,"Summerland CDP, California",0,844,75714,1330,9,0,-9,NA,-1,0,0,0.006766917293233083,0,-0.006766917293233083
0675994,"Sunnyside CDP, California",307,4558,"Sunnyside CDP, California",252,4464,75994,3984,132,-55,120,-0.1791530944625407,0.9090909090909091,0.06735410267661254,0.056451612903225805,0.03313253012048193,-0.010902489773386738,0.023319082782743875
0676015,"Sunnyside-Tahoe City CDP, California",36,1552,"Sunnyside-Tahoe City CDP, California",0,1164,76015,1643,4,-36,-4,-1,-1,0.023195876288659795,0,0.002434570906877663,-0.023195876288659795,-0.002434570906877663
0676022,"Sunnyslope CDP, California",65,4896,NA,NA,NA,76022,3892,101,NA,NA,NA,NA,0.013276143790849673,NA,0.025950668036998973,NA,NA
0676040,"Sunny Slopes CDP, California",0,198,"Sunny Slopes CDP, California",0,67,76040,119,0,0,0,NA,NA,0,0,0,0,0
0677000,"Sunnyvale city, California",3178,136480,"Sunnyvale city, California",2446,152770,77000,117318,4022,-732,-1576,-0.2303335431088735,-0.3918448533068125,0.02328546307151231,0.01601099692347974,0.034282889241207655,-0.007274466148032569,-0.018271892317727915
0677042,"Sunol CDP, California",0,747,"Sunol CDP, California",4,850,77042,793,1,4,3,NA,3,0,0.004705882352941176,0.0012610340479192938,0.004705882352941176,0.0034448483050218822
0677126,"Sunset Beach CDP, California",66,1253,NA,NA,NA,77126,1288,5,NA,NA,NA,NA,0.052673583399840386,NA,0.0038819875776397515,NA,NA
0677308,"Sun Village CDP, California",744,10692,"Sun Village CDP, California",748,13819,77308,8045,1125,4,-377,0.005376344086021506,-0.33511111111111114,0.06958473625140292,0.054128373977856574,0.13983840894965818,-0.015456362273546347,-0.0857100349718016
0677364,"Susanville city, California",1625,17460,"Susanville city, California",2148,15064,77364,7867,91,523,2057,0.32184615384615384,22.604395604395606,0.09306987399770905,0.14259160913436006,0.011567306470064828,0.04952173513665101,0.13102430266429524
0677378,"Sutter CDP, California",37,2924,"Sutter CDP, California",0,3005,77378,2628,17,-37,-17,-1,-1,0.01265389876880985,0,0.006468797564687975,-0.01265389876880985,-0.006468797564687975
0677392,"Sutter Creek city, California",0,2827,"Sutter Creek city, California",3,2573,77392,1868,6,3,-3,NA,-0.5,0,0.001165954139137194,0.0032119914346895075,0.001165954139137194,-0.002046037295552313
0677430,"Swall Meadows CDP, California",0,397,"Swall Meadows CDP, California",0,251,77430,107,0,0,0,NA,NA,0,0,0,0,0
0677574,"Taft city, California",248,9370,"Taft city, California",125,9372,77574,6097,62,-123,63,-0.4959677419354839,1.0161290322580645,0.02646744930629669,0.01333760136577038,0.01016893554206987,-0.01312984794052631,0.00316866582370051
0677588,"Taft Heights CDP, California",61,1906,"Taft Heights CDP, California",23,1998,77588,1873,6,-38,17,-0.6229508196721312,2.8333333333333335,0.032004197271773345,0.011511511511511512,0.003203416978109984,-0.020492685760261833,0.008308094533401528
0677595,"Taft Mosswood CDP, California",321,1528,"Taft Mosswood CDP, California",142,1104,77595,1323,415,-179,-273,-0.557632398753894,-0.6578313253012048,0.2100785340314136,0.1286231884057971,0.31368102796674224,-0.08145534562561652,-0.18505783956094515
0677700,"Tahoe Vista CDP, California",0,1539,"Tahoe Vista CDP, California",0,1158,77700,1144,4,0,-4,NA,-1,0,0,0.0034965034965034965,0,-0.0034965034965034965
0677728,"Tahoma CDP, California",0,1038,"Tahoma CDP, California",0,974,77728,1041,6,0,-6,NA,-1,0,0,0.005763688760806916,0,-0.005763688760806916
0677784,"Talmage CDP, California",11,1040,"Talmage CDP, California",48,1003,77784,982,5,37,43,3.3636363636363638,8.6,0.010576923076923078,0.047856430707876374,0.0050916496945010185,0.03727950763095329,0.04276478101337536
0677805,"Tamalpais-Homestead Valley CDP, California",68,10601,"Tamalpais-Homestead Valley CDP, California",153,11689,77805,9515,132,85,21,1.25,0.1590909090909091,0.006414489199132158,0.013089229189836599,0.013872832369942197,0.006674739990704441,-7.836031801055979e-4
0677924,"Tara Hills CDP, California",688,4611,"Tara Hills CDP, California",700,5117,77924,4890,589,12,111,0.01744186046511628,0.18845500848896435,0.14920841466059423,0.13679890560875513,0.12044989775051125,-0.012409509051839102,0.016349007858243877
0677960,"Tarpey Village CDP, California",50,3962,"Tarpey Village CDP, California",45,3609,77960,4027,60,-5,-15,-0.1,-0.25,0.012619888944977285,0.012468827930174564,0.014899428855227216,-1.5106101480272076e-4,-0.0024306009250526523
0678008,"Taylorsville CDP, California",0,122,"Taylorsville CDP, California",0,198,78008,166,0,0,0,NA,NA,0,0,0,0,0
0678050,"Tecopa CDP, California",0,101,"Tecopa CDP, California",0,168,78050,229,2,0,-2,NA,-1,0,0,0.008733624454148471,0,-0.008733624454148471
0678092,"Tehachapi city, California",1552,14080,"Tehachapi city, California",1276,12680,78092,11622,2097,-276,-821,-0.17783505154639176,-0.3915116833571769,0.11022727272727273,0.10063091482649843,0.1804336602994321,-0.009596357900774302,-0.07980274547293369
0678106,"Tehama city, California",0,436,"Tehama city, California",0,481,78106,401,6,0,-6,NA,-1,0,0,0.014962593516209476,0,-0.014962593516209476
0678120,"Temecula city, California",3820,95829,"Temecula city, California",5173,113381,78120,27124,414,1353,4759,0.3541884816753927,11.495169082125605,0.03986267205125797,0.04562492833896332,0.01526323551098658,0.005762256287705346,0.03036169282797674
0678126,"Temelec CDP, California",0,1453,"Temelec CDP, California",0,1620,78126,1594,1,0,-1,NA,-1,0,0,6.273525721455458e-4,0,-6.273525721455458e-4
0678134,"Temescal Valley CDP, California",987,22630,"Temescal Valley CDP, California",2502,27630,78134,4194,85,1515,2417,1.534954407294833,28.435294117647057,0.04361467079098542,0.09055374592833876,0.02026704816404387,0.04693907513735334,0.07028669776429489
0678148,"Temple City city, California",198,35222,"Temple City city, California",228,36042,78148,31114,192,30,36,0.15151515151515152,0.1875,0.005621486570893191,0.006325953054769436,0.006170855563411969,7.044664838762446e-4,1.5509749135746674e-4
0678162,"Templeton CDP, California",34,8015,"Templeton CDP, California",2,7838,78162,4806,33,-32,-31,-0.9411764705882353,-0.9393939393939394,0.004242046163443544,2.5516713447307985e-4,0.00686641697877653,-0.003986879028970464,-0.00661124984430345
0678176,"Tennant CDP, California",0,46,"Tennant CDP, California",0,26,78176,96,0,0,0,NA,NA,0,0,0,0,0
0678232,"Terminous CDP, California",0,409,"Terminous CDP, California",0,446,78232,514,7,0,-7,NA,-1,0,0,0.013618677042801557,0,-0.013618677042801557
0678288,"Terra Bella CDP, California",0,3551,"Terra Bella CDP, California",0,3182,78288,2918,5,0,-5,NA,-1,0,0,0.0017135023989033585,0,-0.0017135023989033585
0678336,"Teviston CDP, California",58,1044,"Teviston CDP, California",115,881,78336,570,123,57,-8,0.9827586206896551,-0.06504065040650407,0.05555555555555555,0.13053348467650397,0.21578947368421053,0.07497792912094842,-0.08525598900770656
0678456,"Thermal CDP, California",111,2490,"Thermal CDP, California",2,1333,78456,2793,45,-109,-43,-0.9819819819819819,-0.9555555555555556,0.04457831325301205,0.0015003750937734434,0.01611170784103115,-0.043077938159238605,-0.014611332747257707
0678470,"Thermalito CDP, California",79,6001,"Thermalito CDP, California",82,6894,78470,5685,33,3,49,0.0379746835443038,1.4848484848484849,0.013164472587902017,0.011894400928343487,0.005804749340369393,-0.0012700716595585304,0.006089651587974094
0678568,"Thornton CDP, California",6,847,"Thornton CDP, California",25,1033,78568,847,7,19,18,3.1666666666666665,2.5714285714285716,0.0070838252656434475,0.02420135527589545,0.008264462809917356,0.017117530010252003,0.015936892465978094
0678582,"Thousand Oaks city, California",1171,124671,"Thousand Oaks city, California",1773,127873,78582,104492,1272,602,501,0.5140905209222887,0.3938679245283019,0.009392721643365338,0.01386531949668812,0.012173180721969146,0.004472597853322782,0.001692138774718974
0678596,"Thousand Palms CDP, California",89,7185,"Thousand Palms CDP, California",25,6794,78596,4638,28,-64,-3,-0.7191011235955056,-0.10714285714285714,0.012386917188587334,0.0036797173977038563,0.00603708495040966,-0.008707199790883477,-0.0023573675527058034
0678638,"Three Rivers CDP, California",14,1949,"Three Rivers CDP, California",48,2424,78638,2213,11,34,37,2.4285714285714284,3.3636363636363638,0.007183170856849667,0.019801980198019802,0.004970628106642567,0.012618809341170135,0.014831352091377235
0678652,"Three Rocks CDP, California",0,168,"Three Rocks CDP, California",0,249,78652,322,0,0,0,NA,NA,0,0,0,0,0
0678666,"Tiburon town, California",0,8831,"Tiburon town, California",92,9144,78666,7653,69,92,23,NA,0.3333333333333333,0,0.010061242344706912,0.00901607212857703,0.010061242344706912,0.0010451702161298829
0678715,"Timber Cove CDP, California",0,149,"Timber Cove CDP, California",0,141,78715,129,0,0,0,NA,NA,0,0,0,0,0
0678750,"Tipton CDP, California",3,2172,"Tipton CDP, California",0,3238,78750,1383,4,-3,-4,-1,-1,0.0013812154696132596,0,0.0028922631959508315,-0.0013812154696132596,-0.0028922631959508315
0678792,"Tobin CDP, California",0,0,"Tobin CDP, California",0,0,NA,NA,NA,0,NA,NA,NA,NA,NA,NA,NA,NA
0678890,"Tomales CDP, California",0,255,"Tomales CDP, California",0,191,78890,203,8,0,-8,NA,-1,0,0,0.03940886699507389,0,-0.03940886699507389
0678932,"Tonyville CDP, California",0,262,"Tonyville CDP, California",0,388,78932,301,0,0,0,NA,NA,0,0,0,0,0
0678949,"Tooleville CDP, California",0,200,"Tooleville CDP, California",0,167,78949,255,0,0,0,NA,NA,0,0,0,0,0
0678960,"Topanga CDP, California",242,8520,"Topanga CDP, California",146,7900,78960,7221,61,-96,85,-0.39669421487603307,1.3934426229508197,0.0284037558685446,0.01848101265822785,0.008447583437197065,-0.009922743210316751,0.010033429221030784
0679030,"Topaz CDP, California",0,0,"Topaz CDP, California",0,126,79030,48,0,0,0,NA,NA,NA,0,0,NA,0
0679529,"Toro Canyon CDP, California",0,1344,"Toro Canyon CDP, California",0,1728,79529,1230,0,0,0,NA,NA,0,0,0,0,0
0680000,"Torrance city, California",4092,143951,"Torrance city, California",4231,145492,80000,133414,1945,139,2286,0.03396871945259042,1.1753213367609254,0.028426339518308315,0.029080636736040468,0.01457867989866131,6.542972177321534e-4,0.014501956837379159
0680238,"Tracy city, California",5091,79416,"Tracy city, California",4111,90675,80238,34591,866,-980,3245,-0.19249656256138284,3.7471131639722866,0.0641054699304926,0.0453377446925834,0.025035413835968894,-0.0187677252379092,0.020302330856614505
0680266,"Tranquillity CDP, California",0,1224,"Tranquillity CDP, California",0,809,80266,771,0,0,0,NA,NA,0,0,0,0,0
0680280,"Traver CDP, California",0,1175,"Traver CDP, California",0,754,80280,790,0,0,0,NA,NA,0,0,0,0,0
0680364,"Tres Pinos CDP, California",0,266,"Tres Pinos CDP, California",0,683,80364,260,0,0,0,NA,NA,0,0,0,0,0
0680448,"Trinidad city, California",0,259,"Trinidad city, California",0,324,80448,384,1,0,-1,NA,-1,0,0,0.0026041666666666665,0,-0.0026041666666666665
0680476,"Trinity Center CDP, California",0,209,"Trinity Center CDP, California",0,154,80476,291,0,0,0,NA,NA,0,0,0,0,0
0680483,"Trinity Village CDP, California",0,128,"Trinity Village CDP, California",0,253,80483,206,0,0,0,NA,NA,0,0,0,0,0
0680515,"Trona CDP, California",0,17,"Trona CDP, California",0,40,80515,3,0,0,0,NA,NA,0,0,0,0,0
0680560,"Trowbridge CDP, California",0,151,"Trowbridge CDP, California",5,254,80560,197,0,5,5,NA,NA,0,0.01968503937007874,0,0.01968503937007874,0.01968503937007874
0680588,"Truckee town, California",88,15864,"Truckee town, California",101,16474,80588,8914,16,13,85,0.14772727272727273,5.3125,0.005547150781643974,0.006130872890615515,0.0017949293246578416,5.83722108971541e-4,0.004335943565957673
0680644,"Tulare city, California",2451,56938,"Tulare city, California",2320,63547,80644,36036,2085,-131,235,-0.05344757241942064,0.11270983213429256,0.043046822859952934,0.03650841109729806,0.057858807858807856,-0.006538411762654871,-0.021350396761509793
0680686,"Tulelake city, California",44,895,"Tulelake city, California",0,842,80686,1010,0,-44,0,-1,NA,0.049162011173184354,0,0,-0.049162011173184354,0
0680763,"Tuolumne City CDP, California",0,2039,"Tuolumne City CDP, California",2,1583,80763,1686,3,2,-1,NA,-0.3333333333333333,0,0.0012634238787113076,0.0017793594306049821,0.0012634238787113076,-5.159355518936746e-4
0680784,"Tupman CDP, California",0,119,"Tupman CDP, California",0,144,80784,241,0,0,0,NA,NA,0,0,0,0,0
0680812,"Turlock city, California",1137,67376,"Turlock city, California",1936,72904,80812,43633,514,799,1422,0.702726473175022,2.7665369649805447,0.01687544526240798,0.02655547020739603,0.011780074714092545,0.009680024944988048,0.014775395493303483
0680854,"Tustin city, California",1727,73731,"Tustin city, California",2130,79863,80854,51213,3019,403,-889,0.23335263462651998,-0.29446836700894335,0.02342298354830397,0.026670673528417416,0.058949876008044834,0.003247689980113447,-0.032279202479627414
0680882,"Tuttle CDP, California",0,55,"Tuttle CDP, California",0,94,80882,141,0,0,0,NA,NA,0,0,0,0,0
0680896,"Tuttletown CDP, California",0,845,"Tuttletown CDP, California",0,1003,80896,243,0,0,0,NA,NA,0,0,0,0,0
0680952,"Twain CDP, California",0,67,"Twain CDP, California",0,327,80952,39,2,0,-2,NA,-1,0,0,0.05128205128205128,0,-0.05128205128205128
0680966,"Twain Harte CDP, California",0,2262,"Twain Harte CDP, California",0,2311,80966,2176,2,0,-2,NA,-1,0,0,9.191176470588235e-4,0,-9.191176470588235e-4
0680994,"Twentynine Palms city, California",1907,26215,"Twentynine Palms city, California",2667,26147,80994,22480,3005,760,-338,0.3985317252228631,-0.1124792013311148,0.07274461186343696,0.10200022947183233,0.13367437722419928,0.029255617608395373,-0.031674147752366946
0681050,"Twin Lakes CDP, California",52,5005,"Twin Lakes CDP, California",38,5196,81050,5379,94,-14,-56,-0.2692307692307692,-0.5957446808510638,0.01038961038961039,0.007313317936874519,0.0174753671686187,-0.003076292452735871,-0.010162049231744182
0681134,"Ukiah city, California",277,15942,"Ukiah city, California",183,15943,81134,14599,146,-94,37,-0.33935018050541516,0.2534246575342466,0.01737548613724752,0.011478391770683058,0.01000068497842318,-0.005897094366564463,0.001477706792259878
0681204,"Union City city, California",4238,68081,"Union City city, California",3693,74722,81204,53770,4612,-545,-919,-0.12859839546956112,-0.1992627927146574,0.062249379415696006,0.04942319531061803,0.0857727357262414,-0.012826184105077978,-0.036349540415623376
0681302,"University of California Davis CDP, California",131,7710,"University of California-Davis CDP, California",96,7311,81302,5221,240,-35,-144,-0.26717557251908397,-0.6,0.016990920881971464,0.013130898645876077,0.04596820532465045,-0.0038600222360953874,-0.032837306678774374
0681312,"University of California Merced CDP, California",0,0,"University of California-Merced CDP, California",0,0,81312,3,0,0,0,NA,NA,NA,NA,0,NA,NA
0681344,"Upland city, California",4500,73887,"Upland city, California",4512,76596,81344,63616,3385,12,1127,0.0026666666666666666,0.3329394387001477,0.06090381257866742,0.05890647031176563,0.05320988430583501,-0.0019973422669017915,0.005696586005930621
0681358,"Upper Lake CDP, California",0,1213,"Upper Lake CDP, California",15,896,81358,868,6,15,9,NA,1.5,0,0.016741071428571428,0.0069124423963133645,0.016741071428571428,0.009828629032258063
0681554,"Vacaville city, California",9579,91928,"Vacaville city, California",10001,98875,81554,71725,6371,422,3630,0.04405470299613738,0.5697692669910532,0.10420111391523801,0.10114791403286978,0.08882537469501568,-0.0030531998823682266,0.0123225393378541
0681638,"Valinda CDP, California",339,22157,"Valinda CDP, California",465,23705,81638,18808,970,126,-505,0.37168141592920356,-0.520618556701031,0.01529990522182606,0.019616114743724954,0.051573798383666526,0.0043162095218988936,-0.03195768363994157
0681652,"Vallecito CDP, California",0,538,"Vallecito CDP, California",0,234,81652,346,1,0,-1,NA,-1,0,0,0.002890173410404624,0,-0.002890173410404624
0681666,"Vallejo city, California",25565,116030,"Vallejo city, California",24617,121267,81666,109202,23101,-948,1516,-0.03708194797574809,0.06562486472447081,0.2203309488925278,0.20299834250043292,0.2115437446200619,-0.017332606392094885,-0.008545402119628981
0681708,"Valle Vista CDP, California",389,13957,"Valle Vista CDP, California",846,17663,81708,10107,29,457,817,1.1748071979434447,28.17241379310345,0.027871319051372072,0.047896733284266545,0.0028692985059859503,0.020025414232894473,0.0450274347782806
0681722,"Valley Acres CDP, California",15,562,"Valley Acres CDP, California",0,656,81722,509,0,-15,0,-1,NA,0.026690391459074734,0,0,-0.026690391459074734,0
0681736,"Valley Center CDP, California",68,9022,"Valley Center CDP, California",98,11077,81736,6076,29,30,69,0.4411764705882353,2.3793103448275863,0.007537131456439814,0.00884716078360567,0.004772876892692561,0.001310029327165856,0.004074283890913109
0681778,"Valley Ford CDP, California",0,86,"Valley Ford CDP, California",0,34,81778,114,0,0,0,NA,NA,0,0,0,0,0
0681792,"Valley Home CDP, California",0,483,"Valley Home CDP, California",0,185,81792,217,0,0,0,NA,NA,0,0,0,0,0
0681869,"Valley Ranch CDP, California",0,119,"Valley Ranch CDP, California",0,0,81869,58,0,0,0,NA,NA,0,NA,0,NA,NA
0681890,"Valley Springs CDP, California",12,4031,"Valley Springs CDP, California",0,3502,81890,1617,2,-12,-2,-1,-1,0.002976928801786157,0,0.0012368583797155227,-0.002976928801786157,-0.0012368583797155227
0681925,"Valley Wells CDP, California",0,0,"Valley Wells CDP, California",0,0,NA,NA,NA,0,NA,NA,NA,NA,NA,NA,NA,NA
0681967,"Val Verde CDP, California",66,2603,"Val Verde CDP, California",72,2734,81967,2024,186,6,-114,0.09090909090909091,-0.6129032258064516,0.025355359200922013,0.026335040234089245,0.09189723320158102,9.796810331672325e-4,-0.06556219296749177
0682072,"Vandenberg AFB CDP, California",142,3744,"Vandenberg AFB CDP, California",367,3387,82072,9846,1360,225,-993,1.5845070422535212,-0.7301470588235294,0.037927350427350424,0.10835547682314733,0.13812715823684746,0.0704281263957969,-0.029771681413700124
0682086,"Vandenberg Village CDP, California",38,6317,"Vandenberg Village CDP, California",355,8114,82086,5971,348,317,7,8.342105263157896,0.020114942528735632,0.006015513693208801,0.043751540547202365,0.05828169485848267,0.03773602685399356,-0.014530154311280304
0682334,"Verdi CDP, California",0,185,"Verdi CDP, California",0,188,82334,143,0,0,0,NA,NA,0,0,0,0,0
0682422,"Vernon city, California",0,128,"Vernon city, California",18,130,82422,152,5,18,13,NA,2.6,0,0.13846153846153847,0.03289473684210526,0.13846153846153847,0.10556680161943321
0682562,"Victor CDP, California",0,274,"Victor CDP, California",0,215,82562,303,0,0,0,NA,NA,0,0,0,0,0
0682590,"Victorville city, California",17166,108088,"Victorville city, California",20456,121902,82590,50207,5088,3290,15368,0.19165792846324128,3.020440251572327,0.15881503959736512,0.16780692687568702,0.10134045053478599,0.008991887278321897,0.06646647634090103
0682667,"View Park-Windsor Hills CDP, California",9469,10768,"View Park-Windsor Hills CDP, California",9205,11756,82667,11997,10537,-264,-1332,-0.027880452001267292,-0.12641169213248551,0.8793647845468053,0.7830044232732222,0.8783029090605985,-0.09636036127358316,-0.09529848578737632
0682744,"Villa Park city, California",8,5813,"Villa Park city, California",27,5861,82744,6205,27,19,0,2.375,0,0.0013762257010149664,0.004606722402320423,0.004351329572925061,0.0032304967013054567,2.553928293953624e-4
0682786,"Vina CDP, California",0,72,"Vina CDP, California",0,230,82786,159,1,0,-1,NA,-1,0,0,0.006289308176100629,0,-0.006289308176100629
0682814,"Vincent CDP, California",432,16204,"Vincent CDP, California",209,16225,82814,13881,398,-223,-189,-0.5162037037037037,-0.4748743718592965,0.026660083929893854,0.01288135593220339,0.028672285858367553,-0.013778727997690464,-0.01579092992616416
0682842,"Vine Hill CDP, California",188,3435,"Vine Hill CDP, California",25,3886,82842,3113,63,-163,-38,-0.8670212765957447,-0.6031746031746031,0.05473071324599709,0.006433350488934638,0.020237712817218118,-0.04829736275706245,-0.01380436232828348
0682852,"Vineyard CDP, California",2427,25388,"Vineyard CDP, California",2534,28386,82852,4131,154,107,2380,0.044087350638648534,15.454545454545455,0.0955963447297936,0.08926935813429156,0.03727910917453401,-0.006326986595502043,0.05199024895975755
0682954,"Visalia city, California",2403,119312,"Visalia city, California",2984,132104,82954,80755,1163,581,1821,0.24178110694964627,1.5657781599312124,0.020140472039694247,0.02258826379216375,0.014401585041173922,0.002447791752469501,0.008186678750989827
0682996,"Vista city, California",2456,92478,"Vista city, California",3107,100686,82996,73012,3239,651,-132,0.26506514657980457,-0.04075331892559432,0.026557667769631695,0.030858311979818445,0.04436257053635019,0.004300644210186749,-0.013504258556531746
0683085,"Vista Santa Rosa CDP, California",0,3155,"Vista Santa Rosa CDP, California",0,2739,83085,2961,18,0,-18,NA,-1,0,0,0.0060790273556231,0,-0.0060790273556231
0683094,"Volcano CDP, California",0,177,"Volcano CDP, California",0,40,83094,58,0,0,0,NA,NA,0,0,0,0,0
0683108,"Volta CDP, California",0,116,"Volta CDP, California",14,128,83108,334,5,14,9,NA,1.8,0,0.109375,0.014970059880239521,0.109375,0.09440494011976047
0683215,"Contra Costa Centre CDP, California",69,5596,"Contra Costa Centre CDP, California",232,6558,83215,2857,44,163,188,2.36231884057971,4.2727272727272725,0.01233023588277341,0.03537663921927417,0.015400770038501925,0.023046403336500758,0.019975869180772245
0683262,"Walker CDP, California",0,677,"Walker CDP, California",0,858,83262,758,1,0,-1,NA,-1,0,0,0.0013192612137203166,0,-0.0013192612137203166
0683304,"Wallace CDP, California",0,160,"Wallace CDP, California",0,944,83304,162,0,0,0,NA,NA,0,0,0,0,0
0683332,"Walnut city, California",768,29327,"Walnut city, California",1273,29903,83332,29105,1925,505,-652,0.6575520833333334,-0.3387012987012987,0.026187472295154637,0.042570979500384576,0.06613983851571895,0.01638350720522994,-0.02356885901533437
0683346,"Walnut Creek city, California",1118,63808,"Walnut Creek city, California",1427,69567,83346,60938,639,309,788,0.276386404293381,1.2331768388106417,0.017521313941825475,0.020512599364641282,0.010486067806623126,0.0029912854228158064,0.010026531558018156
0683374,"Walnut Grove CDP, California",0,1409,"Walnut Grove CDP, California",12,1364,83374,1137,4,12,8,NA,2,0,0.008797653958944282,0.003518029903254178,0.008797653958944282,0.0052796240556901046
0683402,"Walnut Park CDP, California",0,16686,"Walnut Park CDP, California",13,15896,83402,14722,54,13,-41,NA,-0.7592592592592593,0,8.178158027176649e-4,0.0036679798940361364,8.178158027176649e-4,-0.0028501640913184715
0683460,"Warm Springs CDP, California",12,2117,"Warm Springs CDP, California",0,1874,83460,1678,29,-12,-29,-1,-1,0.005668398677373642,0,0.01728247914183552,-0.005668398677373642,-0.01728247914183552
0683494,"Warner Valley CDP, California",0,0,"Warner Valley CDP, California",0,0,NA,NA,NA,0,NA,NA,NA,NA,NA,NA,NA,NA
0683542,"Wasco city, California",2037,25143,"Wasco city, California",1649,27193,83542,12519,689,-388,960,-0.19047619047619047,1.3933236574746009,0.08101658513303901,0.06064060603831869,0.055036344755970926,-0.020375979094720324,0.0056042612823477625
0683570,"Washington CDP, California",0,37,"Washington CDP, California",0,56,83570,137,0,0,0,NA,NA,0,0,0,0,0
0683612,"Waterford city, California",47,8315,"Waterford city, California",75,8877,83612,4839,15,28,60,0.5957446808510638,4,0.0056524353577871314,0.00844880027036161,0.0030998140111593306,0.0027963649125744778,0.005348986259202279
0683626,"Waterloo CDP, California",0,287,"Waterloo CDP, California",0,670,83626,512,0,0,0,NA,NA,0,0,0,0,0
0683668,"Watsonville city, California",348,49580,"Watsonville city, California",477,53800,83668,36555,272,129,205,0.3706896551724138,0.7536764705882353,0.0070189592577652275,0.008866171003717472,0.007440842565996444,0.001847211745952244,0.0014253284377210278
0683724,"Waukena CDP, California",0,154,"Waukena CDP, California",0,149,83724,112,0,0,0,NA,NA,0,0,0,0,0
0683766,"Wawona CDP, California",0,311,"Wawona CDP, California",0,189,83766,89,1,0,-1,NA,-1,0,0,0.011235955056179775,0,-0.011235955056179775
0683794,"Weaverville CDP, California",0,3987,"Weaverville CDP, California",11,3158,83794,3226,10,11,1,NA,0.1,0,0.0034832172260924636,0.0030998140111593306,0.0034832172260924636,3.8340321493313297e-4
0683850,"Weed city, California",232,2950,"Weed city, California",382,2669,83850,3098,371,150,11,0.646551724137931,0.029649595687331536,0.07864406779661016,0.14312476582989883,0.1197546804389929,0.06448069803328867,0.02337008539090593
0683863,"Weedpatch CDP, California",0,2429,"Weedpatch CDP, California",0,2291,83863,2245,1,0,-1,NA,-1,0,0,4.4543429844097997e-4,0,-4.4543429844097997e-4
0683948,"Weldon CDP, California",18,2304,"Weldon CDP, California",54,2321,83948,2390,1,36,53,2,53,0.0078125,0.023265833692373977,4.1841004184100416e-4,0.015453333692373977,0.022847423650532973
0684004,"Weott CDP, California",0,176,"Weott CDP, California",0,304,84004,166,0,0,0,NA,NA,0,0,0,0,0
0684116,"West Athens CDP, California",4721,8307,"West Athens CDP, California",5061,9706,84116,8859,5575,340,-514,0.07201864011861894,-0.09219730941704037,0.5683158781750332,0.5214300432722028,0.6293035331301501,-0.04688583490283038,-0.10787348985794731
0684120,"West Bishop CDP, California",146,2724,"West Bishop CDP, California",0,2734,84120,2888,2,-146,-2,-1,-1,0.053597650513950074,0,6.925207756232687e-4,-0.053597650513950074,-6.925207756232687e-4
0684144,"West Carson CDP, California",2568,20940,"West Carson CDP, California",2253,22079,84144,20143,1993,-315,260,-0.12266355140186916,0.13045659809332663,0.12263610315186246,0.10204266497576883,0.09894256069105893,-0.02059343817609363,0.003100104284709901
0684200,"West Covina city, California",4551,105552,"West Covina city, California",4483,106589,84200,96122,8200,-68,-3717,-0.014941771039332015,-0.4532926829268293,0.04311618917689859,0.04205874902663502,0.08530825409375585,-0.0010574401502635722,-0.04324950506712083
0684345,"West Goshen CDP, California",12,359,"West Goshen CDP, California",0,427,84345,436,12,-12,-12,-1,-1,0.033426183844011144,0,0.027522935779816515,-0.033426183844011144,-0.027522935779816515
0684385,"Westhaven-Moonstone CDP, California",0,857,"Westhaven-Moonstone CDP, California",0,1110,84385,1115,2,0,-2,NA,-1,0,0,0.0017937219730941704,0,-0.0017937219730941704
0684410,"West Hollywood city, California",780,34657,"West Hollywood city, California",1321,36450,84410,36118,1235,541,86,0.6935897435897436,0.06963562753036437,0.022506275788441006,0.03624142661179698,0.03419347693670746,0.013735150823355975,0.0020479496750895193
0684438,"Westlake Village city, California",108,8274,"Westlake Village city, California",116,8358,84438,7403,54,8,62,0.07407407407407407,1.1481481481481481,0.01305293691080493,0.013878918401531467,0.007294340132378766,8.259814907265357e-4,0.006584578269152701
0684480,"Westley CDP, California",0,1818,"Westley CDP, California",0,968,84480,839,6,0,-6,NA,-1,0,0,0.007151370679380214,0,-0.007151370679380214
0684536,"West Menlo Park CDP, California",83,3401,"West Menlo Park CDP, California",60,4160,84536,3617,30,-23,30,-0.27710843373493976,1,0.024404586886209938,0.014423076923076924,0.008294166436273155,-0.009981509963133014,0.006128910486803769
0684550,"Westminster city, California",793,88921,"Westminster city, California",1337,91137,84550,78293,868,544,469,0.6860025220680959,0.5403225806451613,0.008918028362254136,0.014670221754062565,0.011086559462531771,0.005752193391808429,0.003583662291530794
0684578,"West Modesto CDP, California",109,6222,"West Modesto CDP, California",109,5762,84578,4634,74,0,35,0,0.47297297297297297,0.017518482802957248,0.018917042693509196,0.015968925334484248,0.0013985598905519488,0.0029481173590249488
0684592,"Westmont CDP, California",16405,31301,"Westmont CDP, California",14503,35266,84592,31044,22417,-1902,-7914,-0.11594026211520878,-0.3530356425926752,0.5241046611929331,0.4112459592808938,0.722104110295065,-0.11285870191203928,-0.31085815101417125
0684606,"Westmorland city, California",6,1767,"Westmorland city, California",61,2432,84606,1398,23,55,38,9.166666666666666,1.6521739130434783,0.003395585738539898,0.025082236842105265,0.016452074391988557,0.021686651103565366,0.008630162450116708
0684680,"West Park CDP, California",46,1079,"West Park CDP, California",24,1071,84680,1012,48,-22,-24,-0.4782608695652174,-0.5,0.042632066728452274,0.022408963585434174,0.04743083003952569,-0.0202231031430181,-0.025021866454091515
0684732,"West Point CDP, California",0,852,"West Point CDP, California",0,454,84732,708,0,0,0,NA,NA,0,0,0,0,0
0684774,"West Puente Valley CDP, California",184,22823,"West Puente Valley CDP, California",526,23382,84774,20272,884,342,-358,1.858695652173913,-0.40497737556561086,0.008062042676247645,0.022495937045590626,0.043606945540647195,0.01443389436934298,-0.02111100849505657
0684780,"West Rancho Dominguez CDP, California",2655,5761,"West Rancho Dominguez CDP, California",9850,22901,84780,5451,4104,7195,5746,2.7099811676082863,1.4000974658869396,0.46085749001909393,0.4301122221737042,0.7528893780957623,-0.030745267845389723,-0.3227771559220581
0684816,"West Sacramento city, California",1978,45961,"West Sacramento city, California",2820,53151,84816,28898,692,842,2128,0.4256825075834176,3.0751445086705202,0.04303648745675682,0.053056386521420106,0.023946293861166864,0.010019899064663287,0.02911009266025324
0684921,"West Whittier-Los Nietos CDP, California",179,25188,"West Whittier-Los Nietos CDP, California",183,26654,84921,23292,122,4,61,0.0223463687150838,0.5,0.007106558678735906,0.006865761236587379,0.005237849905546969,-2.4079744214852705e-4,0.0016279113310404096
0684928,"Westwood CDP, California",0,1078,"Westwood CDP, California",66,1645,84928,2017,3,66,63,NA,21,0,0.04012158054711246,0.001487357461576599,0.04012158054711246,0.038634223085535865
0685012,"Wheatland city, California",10,3319,"Wheatland city, California",6,3810,85012,1692,13,-4,-7,-0.4,-0.5384615384615384,0.0030129557095510697,0.0015748031496062992,0.0076832151300236405,-0.0014381525599447705,-0.006108411980417341
0685086,"Whitehawk CDP, California",0,12,"Whitehawk CDP, California",0,49,85086,4,0,0,0,NA,NA,0,0,0,0,0
0685206,"Whitewater CDP, California",31,661,"Whitewater CDP, California",79,890,85206,324,43,48,36,1.5483870967741935,0.8372093023255814,0.046898638426626324,0.08876404494382023,0.13271604938271606,0.04186540651719391,-0.043952004438895825
0685222,"Whitley Gardens CDP, California",22,372,"Whitley Gardens CDP, California",0,224,85222,76,0,-22,0,-1,NA,0.05913978494623656,0,0,-0.05913978494623656,0
0685292,"Whittier city, California",804,84997,"Whittier city, California",1122,86090,85292,77935,991,318,131,0.39552238805970147,0.13218970736629668,0.009459157382025248,0.013032872575211988,0.012715724642330147,0.003573715193186741,3.171479328818415e-4
0685446,"Wildomar city, California",1102,30637,"Wildomar city, California",1517,36445,85446,15834,263,415,1254,0.3765880217785844,4.768060836501901,0.035969579266899504,0.0416243654822335,0.01660982695465454,0.005654786215333996,0.02501453852757896
0685551,"Wilkerson CDP, California",0,563,"Wilkerson CDP, California",0,519,85551,611,0,0,0,NA,NA,0,0,0,0,0
0685586,"Williams city, California",83,4906,"Williams city, California",9,5228,85586,2370,6,-74,3,-0.891566265060241,0.5,0.01691805951895638,0.0017214996174445293,0.002531645569620253,-0.015196559901511851,-8.101459521757239e-4
0685600,"Willits city, California",0,4913,"Willits city, California",64,4893,85600,5027,18,64,46,NA,2.5555555555555554,0,0.01307991007561823,0.003580664412174259,0.01307991007561823,0.009499245663443972
0685614,"Willowbrook CDP, California",14485,35174,"Willowbrook CDP, California",3881,22811,85614,33071,18166,-10604,-14285,-0.7320676561960648,-0.7863591324452274,0.4118098595553534,0.17013721450177546,0.5493030147258928,-0.2416726450535779,-0.3791658002241174
0685642,"Willow Creek CDP, California",0,1276,"Willow Creek CDP, California",0,1513,85642,1500,3,0,-3,NA,-1,0,0,0.002,0,-0.002
0685684,"Willows city, California",126,6205,"Willows city, California",111,6013,85684,5988,33,-15,78,-0.11904761904761904,2.3636363636363638,0.020306204673650283,0.018460003326126725,0.005511022044088177,-0.0018462013475235572,0.012948981282038549
0685866,"Wilsonia CDP, California",0,0,"Wilsonia CDP, California",0,0,85866,18,0,0,0,NA,NA,NA,NA,0,NA,NA
0685880,"Wilton CDP, California",88,5008,"Wilton CDP, California",71,5665,85880,3858,36,-17,35,-0.19318181818181818,0.9722222222222222,0.01757188498402556,0.012533097969991174,0.00933125972006221,-0.005038787014034384,0.003201838249928965
0685894,"Winchester CDP, California",0,2844,"Winchester CDP, California",9,3322,85894,2028,20,9,-11,NA,-0.55,0,0.0027092113184828417,0.009861932938856016,0.0027092113184828417,-0.007152721620373174
0685922,"Windsor town, California",150,25760,"Windsor town, California",250,27447,85922,12316,116,100,134,0.6666666666666666,1.1551724137931034,0.005822981366459627,0.00910846358436259,0.009418642416368951,0.003285482217902963,-3.1017883200636087e-4
0685992,"Winter Gardens CDP, California",359,20193,"Winter Gardens CDP, California",423,23545,85992,18721,135,64,288,0.17827298050139276,2.1333333333333333,0.017778438072599417,0.017965597791463155,0.0072111532503605575,1.871597188637386e-4,0.010754444541102599
0686020,"Winterhaven CDP, California",0,868,"Winterhaven CDP, California",0,192,86020,469,24,0,-24,NA,-1,0,0,0.0511727078891258,0,-0.0511727078891258
0686034,"Winters city, California",0,6572,"Winters city, California",26,7197,86034,4990,14,26,12,NA,0.8571428571428571,0,0.0036126163679310822,0.0028056112224448897,0.0036126163679310822,8.070051454861925e-4
0686076,"Winton CDP, California",241,11103,"Winton CDP, California",52,11288,86076,7723,292,-189,-240,-0.7842323651452282,-0.821917808219178,0.021705845267044943,0.004606661941885188,0.037809141525314,-0.017099183325159757,-0.03320247958342881
0686174,"Wofford Heights CDP, California",0,2497,"Wofford Heights CDP, California",0,2336,86174,2272,0,0,0,NA,NA,0,0,0,0,0
0686216,"Woodacre CDP, California",40,1249,"Woodacre CDP, California",0,1171,86216,1436,4,-40,-4,-1,-1,0.032025620496397116,0,0.002785515320334262,-0.032025620496397116,-0.002785515320334262
0686230,"Woodbridge CDP, California",0,4415,"Woodbridge CDP, California",135,3582,86230,3299,12,135,123,NA,10.25,0,0.03768844221105527,0.003637465898757199,0.03768844221105527,0.03405097631229807
0686244,"Woodcrest CDP, California",314,14296,"Woodcrest CDP, California",1267,17859,86244,10602,571,953,696,3.035031847133758,1.2189141856392294,0.021964185786233912,0.07094462175933702,0.05385776268628561,0.048980435973103115,0.017086859073051415
0686300,"Woodlake city, California",35,7178,"Woodlake city, California",39,7622,86300,5827,1,4,38,0.11428571428571428,38,0.004876010030649206,0.005116767252689583,1.7161489617298782e-4,2.4075722204037683e-4,0.004945152356516595
0686328,"Woodland city, California",712,54785,"Woodland city, California",1121,59710,86328,40904,547,409,574,0.574438202247191,1.0493601462522852,0.012996258099844848,0.018774074694356054,0.01337277527870135,0.005777816594511206,0.005401299415654703
0686380,"Woodlands CDP, California",0,372,"Woodlands CDP, California",0,2028,86380,0,0,0,0,NA,NA,0,0,NA,0,NA
0686440,"Woodside town, California",9,5237,"Woodside town, California",52,5542,86440,5261,17,43,35,4.777777777777778,2.0588235294117645,0.00171854114951308,0.009382894261999277,0.003231324843185706,0.007664353112486198,0.0061515694188135715
0686482,"Woodville CDP, California",0,1866,"Woodville CDP, California",0,1763,86482,1557,6,0,-6,NA,-1,0,0,0.0038535645472061657,0,-0.0038535645472061657
0686594,"Wrightwood CDP, California",0,4566,"Wrightwood CDP, California",12,3984,86594,3469,6,12,6,NA,1,0,0.0030120481927710845,0.0017296050735082155,0.0030120481927710845,0.001282443119262869
0686678,"Yankee Hill CDP, California",0,284,"Yankee Hill CDP, California",0,279,86678,311,1,0,-1,NA,-1,0,0,0.003215434083601286,0,-0.003215434083601286
0686734,"Yettem CDP, California",0,160,"Yettem CDP, California",0,516,86734,221,0,0,0,NA,NA,0,0,0,0,0
0686804,"Yolo CDP, California",0,319,"Yolo CDP, California",0,193,86804,388,0,0,0,NA,NA,0,0,0,0,0
0686832,"Yorba Linda city, California",1093,62915,"Yorba Linda city, California",931,67725,86832,53040,582,-162,349,-0.14821591948764867,0.5996563573883161,0.0173726456329969,0.013746770025839794,0.01097285067873303,-0.0036258756071571065,0.002773919347106763
0686878,"Yosemite Lakes CDP, California",11,4739,"Yosemite Lakes CDP, California",20,5524,86878,2367,17,9,3,0.8181818181818182,0.17647058823529413,0.0023211648027009917,0.003620564808110065,0.007182087029995775,0.0012994000054090734,-0.00356152222188571
0686912,"Yosemite Valley CDP, California",26,361,"Yosemite Valley CDP, California",41,1169,86912,895,29,15,12,0.5769230769230769,0.41379310344827586,0.07202216066481995,0.03507271171941831,0.03240223463687151,-0.03694944894540164,0.0026704770825468002
0686930,"Yountville city, California",34,2939,"Yountville city, California",75,2987,86930,3259,56,41,19,1.2058823529411764,0.3392857142857143,0.011568560734943858,0.025108804820890524,0.01718318502608162,0.013540244085946666,0.007925619794808905
0686944,"Yreka city, California",66,7676,"Yreka city, California",119,7562,86944,6950,35,53,84,0.803030303030303,2.4,0.008598228243877019,0.01573657762496694,0.005035971223021582,0.007138349381089922,0.010700606401945359
0686972,"Yuba City city, California",1278,63435,"Yuba City city, California",1521,66516,86972,37633,799,243,722,0.19014084507042253,0.9036295369211514,0.020146606762828093,0.0228666786938481,0.02123136608827359,0.002720071931020005,0.001635312605574507
0687042,"Yucaipa city, California",722,50227,"Yucaipa city, California",931,53416,87042,33037,177,209,754,0.2894736842105263,4.259887005649717,0.014374738686363908,0.017429234686236333,0.005357629324696553,0.0030544959998724253,0.01207160536153978
0687056,"Yucca Valley town, California",516,20290,"Yucca Valley town, California",1535,21622,87056,16446,214,1019,1321,1.9748062015503876,6.172897196261682,0.02543124691966486,0.07099250763111646,0.013012282621914143,0.0455612607114516,0.057980225009202316
0687090,"Zayante CDP, California",0,810,"Zayante CDP, California",24,794,87090,956,4,24,20,NA,5,0,0.030226700251889168,0.0041841004184100415,0.030226700251889168,0.026042599833479126
0626000,"Fremont city, California",6866,209235,"Fremont city, California",7218,235740,26000,173331,6562,352,656,0.051267113311972035,0.09996952148735141,0.032814777642363846,0.0306184779842199,0.037858201937333774,-0.0021962996581439444,-0.0072397239531138725
0626028,"French Camp CDP, California",474,5779,"French Camp CDP, California",361,3841,26028,3018,478,-113,-117,-0.23839662447257384,-0.24476987447698745,0.08202111091884409,0.09398594116115595,0.15838303512259774,0.01196483024231186,-0.06439709396144179
0626056,"French Gulch CDP, California",0,173,"French Gulch CDP, California",0,433,26056,442,0,0,0,NA,NA,0,0,0,0,0
0626067,"French Valley CDP, California",759,21008,"French Valley CDP, California",3461,36126,26067,706,3,2702,3458,3.559947299077734,1152.6666666666667,0.03612909367859863,0.09580357637158833,0.00424929178470255,0.0596744826929897,0.09155428458688578
0627000,"Fresno city, California",37150,484008,"Fresno city, California",38838,525010,27000,356933,29501,1688,9337,0.045437415881561236,0.3164977458391241,0.07675492967058396,0.07397573379554676,0.08265136594262788,-0.0027791958750372076,-0.008675632147081128
0627014,"Friant CDP, California",0,462,"Friant CDP, California",6,604,27014,509,1,6,5,NA,5,0,0.009933774834437087,0.0019646365422396855,0.009933774834437087,0.0079691382921974
0627080,"Fruitdale CDP, California",11,967,"Fruitdale CDP, California",13,961,27080,788,8,2,5,0.18181818181818182,0.625,0.011375387797311272,0.013527575442247659,0.01015228426395939,0.002152187644936387,0.0033752911782882686
0627130,"Fruitridge Pocket CDP, California",527,5812,"Fruitridge Pocket CDP, California",1216,6116,27130,5527,1356,689,-140,1.3074003795066413,-0.10324483775811209,0.09067446662078459,0.1988227599738391,0.24534105301248416,0.10814829335305452,-0.04651829303864505
0627190,"Fuller Acres CDP, California",0,994,"Fuller Acres CDP, California",0,885,27190,790,0,0,0,NA,NA,0,0,0,0,0
0628000,"Fullerton city, California",3801,132872,"Fullerton city, California",3474,139611,28000,114256,2479,-327,995,-0.08602999210734018,0.40137152077450583,0.028606478415316997,0.024883426091067324,0.021696891191709845,-0.0037230523242496733,0.0031865348993574787
0628014,"Fulton CDP, California",0,596,"Fulton CDP, California",0,655,28014,532,11,0,-11,NA,-1,0,0,0.020676691729323307,0,-0.020676691729323307
0628021,"Furnace Creek CDP, California",0,64,"Furnace Creek CDP, California",10,108,28021,330,3,10,7,NA,2.3333333333333335,0,0.09259259259259259,0.00909090909090909,0.09259259259259259,0.0835016835016835
0628112,"Galt city, California",170,23074,"Galt city, California",539,25990,28112,8937,53,369,486,2.1705882352941175,9.169811320754716,0.007367599895986825,0.02073874567141208,0.00593040170079445,0.013371145775425256,0.014808343970617631
0628154,"Garberville CDP, California",0,644,"Garberville CDP, California",0,913,28154,872,7,0,-7,NA,-1,0,0,0.008027522935779817,0,-0.008027522935779817
0628168,"Gardena city, California",13288,58668,"Gardena city, California",13454,59709,28168,53838,11836,166,1618,0.012492474413004214,0.13670158837445082,0.22649485238971842,0.22532616523472174,0.21984471934321484,-0.0011686871549966837,0.0054814458915068975
0628182,"Garden Acres CDP, California",151,10471,"Garden Acres CDP, California",132,9972,28182,8547,66,-19,66,-0.12582781456953643,1,0.014420781205233503,0.013237063778580024,0.007722007722007722,-0.001183717426653479,0.0055150560565723015
0628210,"Garden Farms CDP, California",0,451,"Garden Farms CDP, California",0,403,28210,368,2,0,-2,NA,-1,0,0,0.005434782608695652,0,-0.005434782608695652
0629000,"Garden Grove city, California",1541,169009,"Garden Grove city, California",1745,173258,29000,144201,2176,204,-431,0.13238157040882545,-0.19806985294117646,0.00911785762888367,0.01007168500155837,0.01509004791922386,9.53827372674701e-4,-0.005018362917665491
0629070,"Garey CDP, California",0,103,"Garey CDP, California",0,191,29070,58,0,0,0,NA,NA,0,0,0,0,0
0629112,"Garnet CDP, California",179,6597,"Garnet CDP, California",326,5285,29112,2380,45,147,281,0.8212290502793296,6.2444444444444445,0.027133545551008033,0.06168401135288552,0.018907563025210083,0.03455046580187749,0.04277644832767544
0629154,"Gasquet CDP, California",0,572,"Gasquet CDP, California",0,685,29154,539,3,0,-3,NA,-1,0,0,0.0055658627087198514,0,-0.0055658627087198514
0629252,"Gazelle CDP, California",0,170,"Gazelle CDP, California",0,56,29252,130,0,0,0,NA,NA,0,0,0,0,0
0629350,"Georgetown CDP, California",24,2378,"Georgetown CDP, California",9,2577,29350,1887,56,-15,-47,-0.625,-0.8392857142857143,0.010092514718250631,0.0034924330616996507,0.0296767355590885,-0.006600081656550981,-0.02618430249738885
0629392,"Gerber CDP, California",0,929,"Gerber CDP, California",0,1140,29392,975,8,0,-8,NA,-1,0,0,0.008205128205128205,0,-0.008205128205128205
0629420,"Geyserville CDP, California",0,993,"Geyserville CDP, California",0,765,29420,846,1,0,-1,NA,-1,0,0,0.001182033096926714,0,-0.001182033096926714
0629504,"Gilroy city, California",734,46807,"Gilroy city, California",872,56766,29504,31566,378,138,494,0.1880108991825613,1.306878306878307,0.01568141517294422,0.015361307825106578,0.011974909712982323,-3.2010734783764067e-4,0.003386398112124255
0629644,"Glen Avon CDP, California",957,19587,NA,NA,NA,29644,14220,443,NA,NA,NA,NA,0.04885893705008424,NA,0.031153305203938116,NA,NA
0630000,"Glendale city, California",3525,192190,"Glendale city, California",3613,200232,30000,180127,2334,88,1279,0.0249645390070922,0.5479862896315338,0.01834122482959571,0.018044068880099084,0.012957524413330595,-2.971559494966275e-4,0.005086544466768489
0630014,"Glendora city, California",1084,49882,"Glendora city, California",997,51801,30014,48109,537,-87,460,-0.08025830258302583,0.8566108007448789,0.021731285834569583,0.019246732688558137,0.011162152611777422,-0.0024845531460114464,0.008084580076780715
0630028,"Glen Ellen CDP, California",14,927,"Glen Ellen CDP, California",0,734,30028,939,5,-14,-5,-1,-1,0.015102481121898598,0,0.005324813631522897,-0.015102481121898598,-0.005324813631522897
0630282,"Golden Hills CDP, California",29,8574,"Golden Hills CDP, California",30,9351,30282,6495,124,1,-94,0.034482758620689655,-0.7580645161290323,0.0033823186377420107,0.003208213025344883,0.019091608929946113,-1.7410561239712772e-4,-0.01588339590460123
0630339,"Gold Mountain CDP, California",0,0,"Gold Mountain CDP, California",0,0,30339,0,0,0,0,NA,NA,NA,NA,NA,NA,NA
0630345,"Gold River CDP, California",150,8339,"Gold River CDP, California",180,7538,30345,3852,34,30,146,0.2,4.294117647058823,0.01798776831754407,0.02387901300079597,0.008826583592938734,0.0058912446832519,0.015052429407857235
0630378,"Goleta city, California",477,29397,"Goleta city, California",1024,30975,30378,26783,614,547,410,1.1467505241090146,0.6677524429967426,0.016226145525053578,0.0330589184826473,0.022924989732292872,0.01683277295759372,0.010133928750354425
0630392,"Gonzales city, California",143,7959,"Gonzales city, California",31,8375,30392,4841,60,-112,-29,-0.7832167832167832,-0.48333333333333334,0.01796708129161955,0.0037014925373134327,0.01239413344350341,-0.014265588754306118,-0.008692640906189977
0630410,"Good Hope CDP, California",754,8112,"Good Hope CDP, California",111,9195,30410,5492,1307,-643,-1196,-0.8527851458885941,-0.9150726855394032,0.09294871794871795,0.012071778140293638,0.23798252002913328,-0.08087693980842431,-0.22591074188883964
0630420,"Goodyears Bar CDP, California",0,198,"Goodyears Bar CDP, California",0,26,30420,4,0,0,0,NA,NA,0,0,0,0,0
0630476,"Goshen CDP, California",0,3214,"Goshen CDP, California",20,3304,30476,2392,52,20,-32,NA,-0.6153846153846154,0,0.006053268765133172,0.021739130434782608,0.006053268765133172,-0.015685861669649435
0630560,"Graeagle CDP, California",0,911,"Graeagle CDP, California",0,538,30560,723,0,0,0,NA,NA,0,0,0,0,0
0630658,"Grand Terrace city, California",474,12115,"Grand Terrace city, California",504,12510,30658,10946,413,30,91,0.06329113924050633,0.22033898305084745,0.03912505158893933,0.04028776978417266,0.03773067787319569,0.0011627181952333296,0.002557091910976972
0630686,"Grangeville CDP, California",0,599,"Grangeville CDP, California",9,346,30686,379,5,9,4,NA,0.8,0,0.02601156069364162,0.013192612137203167,0.02601156069364162,0.012818948556438453
0630693,"Granite Bay CDP, California",180,22681,"Granite Bay CDP, California",826,23183,30693,13215,74,646,752,3.588888888888889,10.162162162162161,0.007936158017724087,0.0356295561402752,0.005599697313658721,0.027693398122551116,0.03002985882661648
0630703,"Granite Hills CDP, California",0,3422,"Granite Hills CDP, California",15,3500,30703,3132,27,15,-12,NA,-0.4444444444444444,0,0.004285714285714286,0.008620689655172414,0.004285714285714286,-0.004334975369458128
0630714,"Graniteville CDP, California",0,0,"Graniteville CDP, California",0,13,NA,NA,NA,0,NA,NA,NA,NA,0,NA,NA,NA
0630798,"Grass Valley city, California",110,12765,"Grass Valley city, California",41,12891,30798,10273,14,-69,27,-0.6272727272727273,1.9285714285714286,0.008617312965139052,0.0031805135365759055,0.0013627956779908499,-0.005436799428563147,0.0018177178585850556
0630812,"Graton CDP, California",14,1598,"Graton CDP, California",0,1889,30812,1409,10,-14,-10,-1,-1,0.008760951188986232,0,0.007097232079488999,-0.008760951188986232,-0.007097232079488999
0630882,"Grayson CDP, California",204,1454,"Grayson CDP, California",0,1364,30882,1085,11,-204,-11,-1,-1,0.14030261348005502,0,0.010138248847926268,-0.14030261348005502,-0.010138248847926268
0630900,"Greeley Hill CDP, California",0,877,"Greeley Hill CDP, California",16,747,30900,789,0,16,16,NA,NA,0,0.0214190093708166,0,0.0214190093708166,0.0214190093708166
0630938,"Greenacres CDP, California",11,5467,"Greenacres CDP, California",23,5911,30938,5211,10,12,13,1.0909090909090908,1.3,0.002012072434607646,0.0038910505836575876,0.0019190174630589138,0.0018789781490499416,0.001972033120598674
0630944,"Green Acres CDP, California",0,1421,"Green Acres CDP, California",39,2607,30944,1367,1,39,38,NA,38,0,0.014959723820483314,7.31528895391368e-4,0.014959723820483314,0.014228194925091947
0630987,"Greenfield CDP, California",77,3996,"Greenfield CDP, California",56,3899,30987,3085,45,-21,11,-0.2727272727272727,0.24444444444444444,0.01926926926926927,0.01436265709156194,0.014586709886547812,-0.004906612177707329,-2.240527949858729e-4
0630994,"Greenfield city, California",121,15480,"Greenfield city, California",190,17373,30994,8004,58,69,132,0.5702479338842975,2.2758620689655173,0.007816537467700259,0.010936510677488057,0.007246376811594203,0.003119973209787798,0.003690133865893854
0631029,"Greenhorn CDP, California",0,203,"Greenhorn CDP, California",0,255,31029,99,0,0,0,NA,NA,0,0,0,0,0
0631092,"Green Valley CDP (Los Angeles County), California",0,1181,"Green Valley CDP (Los Angeles County), California",0,1124,31092,1005,6,0,-6,NA,-1,0,0,0.005970149253731343,0,-0.005970149253731343
0631099,"Green Valley CDP (Solano County), California",74,1593,"Green Valley CDP (Solano County), California",32,1472,31099,2169,37,-42,-5,-0.5675675675675675,-0.13513513513513514,0.04645323289391086,0.021739130434782608,0.01705855232826187,-0.02471410245912825,0.004680578106520738
0631134,"Greenview CDP, California",0,364,"Greenview CDP, California",0,229,31134,328,1,0,-1,NA,-1,0,0,0.003048780487804878,0,-0.003048780487804878
0631162,"Greenville CDP, California",0,994,"Greenville CDP, California",0,817,31162,1385,1,0,-1,NA,-1,0,0,7.220216606498195e-4,0,-7.220216606498195e-4
0631246,"Grenada CDP, California",0,265,"Grenada CDP, California",0,398,31246,325,0,0,0,NA,NA,0,0,0,0,0
0631260,"Gridley city, California",45,6449,"Gridley city, California",70,6744,31260,4979,27,25,43,0.5555555555555556,1.5925925925925926,0.006977826019537912,0.010379596678529062,0.0054227756577626025,0.00340177065899115,0.00495682102076646
0631288,"Grimes CDP, California",0,407,"Grimes CDP, California",0,305,31288,302,0,0,0,NA,NA,0,0,0,0,0
0631302,"Grizzly Flats CDP, California",0,793,"Grizzly Flats CDP, California",0,1195,31302,421,2,0,-2,NA,-1,0,0,0.004750593824228029,0,-0.004750593824228029
0631372,"Groveland CDP, California",0,354,"Groveland CDP, California",0,247,31372,666,0,0,0,NA,NA,0,0,0,0,0
0631393,"Grover Beach city, California",86,13137,"Grover Beach city, California",261,13535,31393,11560,203,175,58,2.0348837209302326,0.2857142857142857,0.006546395676334018,0.019283339490210567,0.01756055363321799,0.012736943813876548,0.0017227858569925751
0631414,"Guadalupe city, California",45,6770,"Guadalupe city, California",44,7451,31414,5566,37,-1,7,-0.022222222222222223,0.1891891891891892,0.0066469719350073855,0.0059052476177694265,0.006647502694933525,-7.41724317237959e-4,-7.422550771640987e-4
0631470,"Guerneville CDP, California",87,4476,"Guerneville CDP, California",66,5014,31470,4526,42,-21,24,-0.2413793103448276,0.5714285714285714,0.01943699731903485,0.01316314319904268,0.009279717189571365,-0.006273854119992171,0.003883426009471315
0631540,"Guinda CDP, California",28,192,"Guinda CDP, California",0,237,31540,164,30,-28,-30,-1,-1,0.14583333333333334,0,0.18292682926829268,-0.14583333333333334,-0.18292682926829268
0631568,"Gustine city, California",9,5438,"Gustine city, California",0,5813,31568,3939,27,-9,-27,-1,-1,0.0016550202280250091,0,0.006854531607006854,-0.0016550202280250091,-0.006854531607006854
0631596,"Hacienda Heights CDP, California",791,53639,"Hacienda Heights CDP, California",613,55188,31596,52666,1102,-178,-489,-0.225031605562579,-0.4437386569872958,0.014746732787710435,0.011107487134884395,0.020924315497664527,-0.0036392456528260408,-0.009816828362780132
0631708,"Half Moon Bay city, California",111,11126,"Half Moon Bay city, California",87,12834,31708,8886,46,-24,41,-0.21621621621621623,0.8913043478260869,0.009976631314039187,0.006778868630201029,0.005176682421787081,-0.003197762683838158,0.0016021862084139478
0631883,"Hamilton Branch CDP, California",0,532,"Hamilton Branch CDP, California",0,495,31883,487,0,0,0,NA,NA,0,0,0,0,0
0631890,"Hamilton City CDP, California",0,1875,"Hamilton City CDP, California",28,2113,31890,1811,23,28,5,NA,0.21739130434782608,0,0.013251301467108376,0.012700165654334622,0.013251301467108376,5.51135812773754e-4
0631960,"Hanford city, California",3887,52315,"Hanford city, California",3054,56475,31960,31363,1620,-833,1434,-0.21430409055827115,0.8851851851851852,0.07429991398260537,0.054077025232403715,0.05165322194943086,-0.020222888750201652,0.0024238032829728556
0632030,"Happy Camp CDP, California",7,1152,"Happy Camp CDP, California",2,844,32030,1574,2,-5,0,-0.7142857142857143,0,0.006076388888888889,0.002369668246445498,0.0012706480304955528,-0.003706720642443391,0.001099020215949945
0632044,"Harbison Canyon CDP, California",14,3465,"Harbison Canyon CDP, California",0,4155,32044,3298,11,-14,-11,-1,-1,0.00404040404040404,0,0.0033353547604608852,-0.00404040404040404,-0.0033353547604608852
0632156,"Hardwick CDP, California",0,93,"Hardwick CDP, California",1,138,32156,163,0,1,1,NA,NA,0,0.007246376811594203,0,0.007246376811594203,0.007246376811594203
0632324,"Hartland CDP, California",0,0,"Hartland CDP, California",0,0,NA,NA,NA,0,NA,NA,NA,NA,NA,NA,NA,NA
0632340,"Hartley CDP, California",103,2739,"Hartley CDP, California",226,2960,32340,2411,86,123,140,1.1941747572815533,1.627906976744186,0.03760496531580869,0.07635135135135135,0.03566984653670676,0.03874638603554266,0.04068150481464459
0632385,"Hasley Canyon CDP, California",0,965,"Hasley Canyon CDP, California",21,1145,NA,NA,NA,21,NA,NA,NA,0,0.01834061135371179,NA,0.01834061135371179,NA
0632408,"Hat Creek CDP, California",0,216,"Hat Creek CDP, California",2,129,32408,348,0,2,2,NA,NA,0,0.015503875968992248,0,0.015503875968992248,0.015503875968992248
0632506,"Hawaiian Gardens city, California",466,14328,"Hawaiian Gardens city, California",577,14337,32506,13639,620,111,-43,0.23819742489270387,-0.06935483870967742,0.03252372975991066,0.040245518588268116,0.045457878143558915,0.007721788828357452,-0.005212359555290799
0632548,"Hawthorne city, California",24395,84195,"Hawthorne city, California",21660,87107,32548,71436,20326,-2735,1334,-0.11211313793810207,0.06563022729509004,0.2897440465585842,0.2486596943988428,0.28453440842152417,-0.041084352159741405,-0.03587471402268136
0632562,"Hayfork CDP, California",0,2055,"Hayfork CDP, California",35,2711,32562,2482,3,35,32,NA,10.666666666666666,0,0.012910365178900774,0.0012087026591458502,0.012910365178900774,0.011701662519754925
0633000,"Hayward city, California",17116,141498,"Hayward city, California",15214,159293,33000,115192,11274,-1902,3940,-0.11112409441458285,0.34947667198864646,0.12096284046417617,0.09550953274782947,0.09787137995694145,-0.0254533077163467,-0.002361847209111978
0633056,"Healdsburg city, California",19,11082,"Healdsburg city, California",0,11845,33056,10018,15,-19,-15,-1,-1,0.0017144919689586718,0,0.001497304851267718,-0.0017144919689586718,-0.001497304851267718
0633084,"Heber CDP, California",0,5022,"Heber CDP, California",0,3604,33084,2566,18,0,-18,NA,-1,0,0,0.007014809041309431,0,-0.007014809041309431
0633182,"Hemet city, California",3211,76403,"Hemet city, California",6763,84542,33182,49010,330,3552,6433,1.1061974462784179,19.493939393939392,0.04202714553093465,0.07999574176149132,0.0067333197306672105,0.03796859623055667,0.07326242203082411
0633294,"Herald CDP, California",0,990,"Herald CDP, California",54,967,33294,866,18,54,36,NA,2,0,0.055842812823164424,0.020785219399538105,0.055842812823164424,0.03505759342362632
0633308,"Hercules city, California",4225,23061,"Hercules city, California",3873,25616,33308,16829,2150,-352,1723,-0.08331360946745563,0.8013953488372093,0.1832097480594944,0.1511945658963148,0.12775565987283855,-0.032015182163179584,0.023438906023476258
0633336,"Herlong CDP, California",351,1399,"Herlong CDP, California",296,1295,33336,398,55,-55,241,-0.15669515669515668,4.381818181818182,0.25089349535382416,0.22857142857142856,0.13819095477386933,-0.022322066782395594,0.09038047379755923
0633364,"Hermosa Beach city, California",131,19355,"Hermosa Beach city, California",192,19539,33364,18219,211,61,-19,0.46564885496183206,-0.09004739336492891,0.0067682769310255745,0.009826500844464917,0.011581316208353917,0.003058223913439342,-0.0017548153638890004
0633434,"Hesperia city, California",4638,86405,"Hesperia city, California",3776,94203,33434,50899,1249,-862,2527,-0.18585597240189736,2.023218574859888,0.05367744922168856,0.04008364914068554,0.024538792510658363,-0.01359380008100302,0.015544856630027176
0633504,"Hickman CDP, California",0,439,"Hickman CDP, California",0,712,33504,561,3,0,-3,NA,-1,0,0,0.0053475935828877,0,-0.0053475935828877
0633518,"Hidden Hills city, California",4,2522,"Hidden Hills city, California",0,1751,33518,1729,8,-4,-8,-1,-1,0.0015860428231562252,0,0.004626951995373048,-0.0015860428231562252,-0.004626951995373048
0633532,"Hidden Meadows CDP, California",87,3930,"Hidden Meadows CDP, California",39,3462,33532,2543,9,-48,30,-0.5517241379310345,3.3333333333333335,0.022137404580152672,0.011265164644714038,0.003539127015336217,-0.010872239935438633,0.007726037629377821
0633549,"Hidden Valley Lake CDP, California",109,6185,"Hidden Valley Lake CDP, California",17,5539,33549,2037,23,-92,-6,-0.8440366972477065,-0.2608695652173913,0.017623282134195634,0.003069146055244629,0.011291114383897889,-0.014554136078951004,-0.00822196832865326
0633574,"Highgrove CDP, California",177,4302,"Highgrove CDP, California",76,5786,33574,3326,175,-101,-99,-0.5706214689265536,-0.5657142857142857,0.041143654114365415,0.013135153819564467,0.052615754660252555,-0.028008500294800946,-0.039480600840688086
0633588,"Highland city, California",4833,52341,"Highland city, California",4799,55049,33588,34581,3792,-34,1007,-0.007034967928822677,0.2655590717299578,0.09233679142545996,0.08717687878072262,0.10965559122061247,-0.005159912644737336,-0.022478712439889845
0633633,"Highlands-Baywood Park CDP, California",81,4147,"Highlands-Baywood Park CDP, California",73,4767,33633,4435,113,-8,-40,-0.09876543209876543,-0.35398230088495575,0.019532191945985048,0.015313614432557163,0.02547914317925592,-0.004218577513427885,-0.010165528746698755
0633798,"Hillsborough town, California",95,10650,"Hillsborough town, California",124,11447,33798,10667,74,29,50,0.30526315789473685,0.6756756756756757,0.00892018779342723,0.01083253254127719,0.00693728320989969,0.0019123447478499606,0.0038952493313775
0633861,"Hilmar-Irwin CDP, California",10,4997,"Hilmar-Irwin CDP, California",0,5755,33861,3448,13,-10,-13,-1,-1,0.0020012007204322593,0,0.0037703016241299302,-0.0020012007204322593,-0.0037703016241299302
0633935,"Hiouchi CDP, California",0,352,"Hiouchi CDP, California",0,244,33935,406,0,0,0,NA,NA,0,0,0,0,0
0634120,"Hollister city, California",497,34539,"Hollister city, California",296,38687,34120,19893,119,-201,177,-0.4044265593561368,1.4873949579831933,0.01438953067546831,0.007651148964768527,0.005982003719901473,-0.006738381710699784,0.001669145244867054
0634246,"Holtville city, California",0,5835,"Holtville city, California",47,6527,34246,4820,10,47,37,NA,3.7,0,0.007200857974567183,0.002074688796680498,0.007200857974567183,0.005126169177886684
0634281,"Home Garden CDP, California",319,1916,"Home Garden CDP, California",86,1521,34281,1551,284,-233,-198,-0.7304075235109718,-0.6971830985915493,0.16649269311064718,0.05654174884944116,0.1831076724693746,-0.10995094426120602,-0.12656592361993343
0634302,"Home Gardens CDP, California",413,10947,"Home Gardens CDP, California",483,12153,34302,7780,118,70,365,0.1694915254237288,3.093220338983051,0.03772723120489632,0.03974327326586028,0.015167095115681234,0.0020160420609639587,0.024576178150179047
0634316,"Homeland CDP, California",60,7004,"Homeland CDP, California",26,7086,34316,4044,12,-34,14,-0.5666666666666667,1.1666666666666667,0.008566533409480296,0.00366920688681908,0.002967359050445104,-0.004897326522661217,7.01847836373976e-4
0634392,"Homestead Valley CDP, California",22,2888,"Homestead Valley CDP, California",28,2865,34392,1247,6,6,22,0.2727272727272727,3.6666666666666665,0.007617728531855956,0.009773123909249564,0.0048115477145148355,0.0021553953773936086,0.004961576194734729
0634405,"Homewood Canyon CDP, California",0,109,"Homewood Canyon CDP, California",0,69,34405,87,0,0,0,NA,NA,0,0,0,0,0
0634428,"Honcut CDP, California",12,572,"Honcut CDP, California",0,116,34428,350,0,-12,0,-1,NA,0.02097902097902098,0,0,-0.02097902097902098,0
0634484,"Hood CDP, California",0,173,"Hood CDP, California",0,313,34484,187,0,0,0,NA,NA,0,0,0,0,0
0634652,"Hopland CDP, California",0,874,"Hopland CDP, California",0,920,34652,651,2,0,-2,NA,-1,0,0,0.0030721966205837174,0,-0.0030721966205837174
0634694,"Hornbrook CDP, California",0,270,"Hornbrook CDP, California",0,211,34694,278,0,0,0,NA,NA,0,0,0,0,0
0634708,"Hornitos CDP, California",0,0,"Hornitos CDP, California",0,66,34708,38,0,0,0,NA,NA,NA,0,0,NA,0
0634904,"Hughson city, California",15,6267,"Hughson city, California",33,7460,34904,3349,7,18,26,1.2,3.7142857142857144,0.0023934897079942556,0.004423592493297587,0.0020901761719916393,0.0020301027853033317,0.002333416321305948
0634928,"Humboldt Hill CDP, California",56,3769,"Humboldt Hill CDP, California",34,4315,34928,2877,13,-22,21,-0.39285714285714285,1.6153846153846154,0.014858052533828601,0.007879490150637311,0.0045185957594716716,-0.00697856238319129,0.0033608943911656395
0636000,"Huntington Beach city, California",1338,188914,"Huntington Beach city, California",2846,200259,36000,181519,1687,1508,1159,1.1270553064275037,0.6870183758150563,0.007082587844204241,0.014211595983201753,0.009293792936276643,0.007129008138997512,0.00491780304692511
0636056,"Huntington Park city, California",372,58642,"Huntington Park city, California",689,58353,36056,56001,594,317,95,0.8521505376344086,0.15993265993265993,0.006343576276388936,0.011807447774750226,0.01060695344725987,0.00546387149836129,0.0012004943274903559
0636084,"Huron city, California",0,6691,"Huron city, California",21,7115,36084,4775,22,21,-1,NA,-0.045454545454545456,0,0.0029515108924806745,0.004607329842931937,0.0029515108924806745,-0.0016558189504512627
0636098,"Hyampom CDP, California",0,191,"Hyampom CDP, California",0,115,36098,244,0,0,0,NA,NA,0,0,0,0,0
0636126,"Hydesville CDP, California",13,1197,"Hydesville CDP, California",0,1063,36126,1131,1,-13,-1,-1,-1,0.01086048454469507,0,8.841732979664014e-4,-0.01086048454469507,-8.841732979664014e-4
0636168,"Idlewild CDP, California",0,30,"Idlewild CDP, California",0,0,36168,22,0,0,0,NA,NA,0,NA,0,NA,NA
0636203,"Idyllwild-Pine Cove CDP, California",0,2193,"Idyllwild-Pine Cove CDP, California",106,2510,36203,2851,8,106,98,NA,12.25,0,0.04223107569721116,0.0028060329708874078,0.04223107569721116,0.03942504272632375
0636280,"Imperial city, California",206,13406,"Imperial city, California",297,17454,36280,4287,145,91,152,0.441747572815534,1.0482758620689656,0.015366253916156945,0.01701615675489859,0.03382318637742011,0.0016499028387416438,-0.016807029622521518
0636294,"Imperial Beach city, California",1378,26254,"Imperial Beach city, California",1429,27315,36294,26512,1310,51,119,0.03701015965166909,0.09083969465648854,0.05248724003961301,0.05231557752150833,0.049411587205793604,-1.716625181046802e-4,0.0029039903157147273
0636350,"Independence CDP, California",2,551,"Independence CDP, California",5,603,36350,695,8,3,-3,1.5,-0.375,0.003629764065335753,0.008291873963515755,0.011510791366906475,0.004662109898180002,-0.00321891740339072
0636364,"Indian Falls CDP, California",0,35,"Indian Falls CDP, California",0,53,36364,35,0,0,0,NA,NA,0,0,0,0,0
0636420,"Indianola CDP, California",0,1029,"Indianola CDP, California",0,739,36420,857,1,0,-1,NA,-1,0,0,0.0011668611435239206,0,-0.0011668611435239206
0636434,"Indian Wells city, California",89,4858,"Indian Wells city, California",49,5370,36434,2779,9,-40,40,-0.449438202247191,4.444444444444445,0.018320296418279126,0.009124767225325885,0.0032385750269881253,-0.009195529192953241,0.00588619219833776
0636448,"Indio city, California",1812,72486,"Indio city, California",3016,89469,36448,38384,1508,1204,1508,0.6644591611479028,1,0.02499793063488122,0.033710000111770555,0.03928720300125052,0.008712069476889336,-0.005577202889479965
0636452,"Indio Hills CDP, California",32,1390,"Indio Hills CDP, California",12,782,36452,699,7,-20,5,-0.625,0.7142857142857143,0.02302158273381295,0.015345268542199489,0.010014306151645207,-0.007676314191613461,0.0053309623905542815
0636490,"Industry city, California",30,368,"Industry city, California",2,373,36490,581,19,-28,-17,-0.9333333333333333,-0.8947368421052632,0.08152173913043478,0.005361930294906166,0.03270223752151463,-0.07615980883552861,-0.027340307226608466
0636546,"Inglewood city, California",48114,110053,"Inglewood city, California",44831,109613,36546,109454,56729,-3283,-11898,-0.06823377811032132,-0.20973399848402052,0.43718935422023936,0.40899345880506877,0.5182907888245291,-0.02819589541517059,-0.10929733001946029
0636613,"Interlaken CDP, California",129,6810,"Interlaken CDP, California",81,7817,36613,6417,54,-48,27,-0.37209302325581395,0.5,0.01894273127753304,0.010362031469873353,0.008415147265077139,-0.008580699807659686,0.0019468842047962141
0636616,"Inverness CDP, California",35,1380,"Inverness CDP, California",0,1097,36616,1430,4,-35,-4,-1,-1,0.025362318840579712,0,0.002797202797202797,-0.025362318840579712,-0.002797202797202797
0636658,"Inyokern CDP, California",0,1676,"Inyokern CDP, California",0,696,36658,1310,11,0,-11,NA,-1,0,0,0.008396946564885497,0,-0.008396946564885497
0636672,"Ione city, California",652,7845,"Ione city, California",815,7753,36672,6540,1569,163,-754,0.25,-0.4805608667941364,0.08311026131293818,0.10512059847800852,0.23990825688073394,0.022010337165070337,-0.13478765840272544
0636735,"Iron Horse CDP, California",0,273,"Iron Horse CDP, California",0,191,36735,195,0,0,0,NA,NA,0,0,0,0,0
0636770,"Irvine city, California",3881,199117,"Irvine city, California",4658,273157,36770,119410,3124,777,1534,0.20020613244009275,0.4910371318822023,0.019491052998990545,0.017052464333698204,0.02616196298467465,-0.0024385886652923405,-0.009109498650976447
0636826,"Irwindale city, California",14,1443,"Irwindale city, California",0,1394,36826,1092,15,-14,-15,-1,-1,0.009702009702009701,0,0.013736263736263736,-0.009702009702009701,-0.013736263736263736
0636868,"Isla Vista CDP, California",366,23776,"Isla Vista CDP, California",923,27707,36868,20395,595,557,328,1.5218579234972678,0.5512605042016807,0.015393674293405114,0.033312881221352,0.029173817112037263,0.017919206927946886,0.004139064109314739
0636882,"Isleton city, California",11,928,"Isleton city, California",0,544,36882,833,12,-11,-12,-1,-1,0.011853448275862068,0,0.014405762304921969,-0.011853448275862068,-0.014405762304921969
0636910,"Ivanhoe CDP, California",0,4315,"Ivanhoe CDP, California",0,4215,36910,3293,1,0,-1,NA,-1,0,0,3.036744609778318e-4,0,-3.036744609778318e-4
0636980,"Jackson city, California",0,4625,"Jackson city, California",14,4751,36980,3593,10,14,4,NA,0.4,0,0.002946748053041465,0.0027831895352073478,0.002946748053041465,1.63558517834117e-4
0637022,"Jacumba CDP, California",0,628,"Jacumba CDP, California",0,307,37022,460,8,0,-8,NA,-1,0,0,0.017391304347826087,0,-0.017391304347826087
0637106,"Jamestown CDP, California",0,3684,"Jamestown CDP, California",0,3107,37106,2226,4,0,-4,NA,-1,0,0,0.0017969451931716084,0,-0.0017969451931716084
0637120,"Jamul CDP, California",46,5319,"Jamul CDP, California",113,5445,37120,4703,59,67,54,1.4565217391304348,0.9152542372881356,0.008648242150780222,0.020752984389348025,0.012545183925154156,0.012104742238567803,0.008207800464193869
0637134,"Janesville CDP, California",0,1204,"Janesville CDP, California",2,1409,37134,1095,8,2,-6,NA,-0.75,0,0.0014194464158978,0.0073059360730593605,0.0014194464158978,-0.00588648965716156
0637274,"Jenner CDP, California",0,99,"Jenner CDP, California",0,30,37274,116,2,0,-2,NA,-1,0,0,0.017241379310344827,0,-0.017241379310344827
0637400,"Johannesburg CDP, California",0,251,"Johannesburg CDP, California",0,119,37400,268,0,0,0,NA,NA,0,0,0,0,0
0637484,"Johnstonville CDP, California",0,519,"Johnstonville CDP, California",0,1132,37484,947,2,0,-2,NA,-1,0,0,0.0021119324181626186,0,-0.0021119324181626186
0637512,"Johnsville CDP, California",0,84,"Johnsville CDP, California",0,0,37512,41,0,0,0,NA,NA,0,NA,0,NA,NA
0637554,"Joshua Tree CDP, California",39,7719,"Joshua Tree CDP, California",69,7581,37554,5764,78,30,-9,0.7692307692307693,-0.11538461538461539,0.005052467936261173,0.009101701622477245,0.013532269257460098,0.004049233686216072,-0.004430567634982853
0637582,"Julian CDP, California",0,1509,"Julian CDP, California",0,1019,37582,1284,2,0,-2,NA,-1,0,0,0.001557632398753894,0,-0.001557632398753894
0637596,"Junction City CDP, California",0,1221,"Junction City CDP, California",0,682,37596,576,1,0,-1,NA,-1,0,0,0.001736111111111111,0,-0.001736111111111111
0637624,"June Lake CDP, California",0,588,"June Lake CDP, California",0,390,37624,574,0,0,0,NA,NA,0,0,0,0,0
0637904,"Keddie CDP, California",0,135,"Keddie CDP, California",0,76,37904,120,1,0,-1,NA,-1,0,0,0.008333333333333333,0,-0.008333333333333333
0637918,"Keeler CDP, California",0,27,"Keeler CDP, California",0,10,37918,67,0,0,0,NA,NA,0,0,0,0,0
0637946,"Keene CDP, California",23,316,"Keene CDP, California",0,228,37946,363,0,-23,0,-1,NA,0.07278481012658228,0,0,-0.07278481012658228,0
0638024,"Kelly Ridge CDP, California",23,2576,"Kelly Ridge CDP, California",32,2850,38024,1921,4,9,28,0.391304347826087,7,0.008928571428571428,0.011228070175438596,0.002082248828735034,0.0022994987468671676,0.009145821346703562
0638044,"Kelseyville CDP, California",0,3126,"Kelseyville CDP, California",58,3560,38044,2987,14,58,44,NA,3.142857142857143,0,0.016292134831460674,0.004686976899899564,0.016292134831460674,0.01160515793156111
0638065,"Kennedy CDP, California",259,3293,"Kennedy CDP, California",139,3356,38065,3018,367,-120,-228,-0.46332046332046334,-0.6212534059945504,0.07865168539325842,0.041418355184743745,0.12160371106693174,-0.03723333020851468,-0.080185355882188
0638076,"Kennedy Meadows CDP, California",0,19,"Kennedy Meadows CDP, California",0,0,38076,23,0,0,0,NA,NA,0,NA,0,NA,NA
0638086,"Kensington CDP, California",29,4918,"Kensington CDP, California",124,5329,38086,4990,150,95,-26,3.2758620689655173,-0.17333333333333334,0.0058967059780398534,0.023268905986113718,0.03006012024048096,0.017372200008073865,-0.006791214254367243
0638114,"Kentfield CDP, California",114,7044,"Kentfield CDP, California",1,7020,38114,6103,30,-113,-29,-0.9912280701754386,-0.9666666666666667,0.016183986371379896,1.4245014245014244e-4,0.004915615271178109,-0.016041536228929756,-0.004773165128727967
0638156,"Kenwood CDP, California",0,462,"Kenwood CDP, California",0,716,38156,1247,5,0,-5,NA,-1,0,0,0.00400962309542903,0,-0.00400962309542903
0638226,"Kerman city, California",0,12708,"Kerman city, California",55,14816,38226,5881,21,55,34,NA,1.619047619047619,0,0.0037122030237580995,0.0035708212888964463,0.0037122030237580995,1.4138173486165318e-4
0638310,"Kernville CDP, California",38,1748,"Kernville CDP, California",2,663,38310,1687,21,-36,-19,-0.9473684210526315,-0.9047619047619048,0.021739130434782608,0.0030165912518853697,0.012448132780082987,-0.01872253918289724,-0.009431541528197617
0638352,"Keswick CDP, California",0,426,"Keswick CDP, California",0,289,38352,407,0,0,0,NA,NA,0,0,0,0,0
0638394,"Kettleman City CDP, California",0,1020,"Kettleman City CDP, California",0,1136,38394,1414,4,0,-4,NA,-1,0,0,0.002828854314002829,0,-0.002828854314002829
0638422,"Keyes CDP, California",152,5079,"Keyes CDP, California",23,6548,38422,3220,0,-129,23,-0.8486842105263158,NA,0.02992715101397913,0.003512522907758094,0,-0.026414628106221034,0.003512522907758094
0638520,"King City city, California",128,12399,"King City city, California",143,13921,38520,7938,64,15,79,0.1171875,1.234375,0.010323413178482135,0.010272250556712879,0.008062484252960444,-5.11626217692563e-5,0.002209766303752435
0638548,"Kings Beach CDP, California",12,3315,"Kings Beach CDP, California",0,3044,38548,2796,7,-12,-7,-1,-1,0.0036199095022624436,0,0.002503576537911302,-0.0036199095022624436,-0.002503576537911302
0638562,"Kingsburg city, California",20,11041,"Kingsburg city, California",95,11955,38562,7356,24,75,71,3.75,2.9583333333333335,0.0018114301240829635,0.00794646591384358,0.0032626427406199023,0.006135035789760617,0.004683823173223679
0638604,"Kingvale CDP, California",0,166,"Kingvale CDP, California",0,71,38604,71,0,0,0,NA,NA,0,0,0,0,0
0638646,"Kirkwood CDP, California",0,110,"Kirkwood CDP, California",9,80,38646,195,4,9,5,NA,1.25,0,0.1125,0.020512820512820513,0.1125,0.0919871794871795
0638702,"Klamath CDP, California",8,893,"Klamath CDP, California",0,632,38702,827,7,-8,-7,-1,-1,0.008958566629339306,0,0.008464328899637243,-0.008958566629339306,-0.008464328899637243
0638772,"Knightsen CDP, California",24,1551,"Knightsen CDP, California",0,1176,38772,1471,2,-24,-2,-1,-1,0.015473887814313346,0,0.0013596193065941536,-0.015473887814313346,-0.0013596193065941536
0638800,"Knights Landing CDP, California",0,900,"Knights Landing CDP, California",0,1036,38800,818,0,0,0,NA,NA,0,0,0,0,0
0639003,"La Cañada Flintridge city, California",40,20254,"La Cañada Flintridge city, California",154,20261,39003,19449,81,114,73,2.85,0.9012345679012346,0.0019749185346104475,0.007600809436849119,0.0041647385469689956,0.005625890902238672,0.003436070889880124
0639045,"La Crescenta-Montrose CDP, California",104,19927,"La Crescenta-Montrose CDP, California",58,19689,39045,16879,59,-46,-1,-0.4423076923076923,-0.01694915254237288,0.005219049530787374,0.0029458073035705215,0.003495467740979916,-0.0022732422272168525,-5.496604374093943e-4
0639094,"Ladera CDP, California",0,1543,"Ladera CDP, California",0,1607,39094,1449,0,0,0,NA,NA,0,0,0,0,0
0639108,"Ladera Heights CDP, California",5229,6690,"Ladera Heights CDP, California",4734,6620,39108,6316,3634,-495,1100,-0.09466437177280551,0.3026967528893781,0.7816143497757847,0.7151057401812689,0.5753641545281823,-0.06650860959451577,0.1397415856530866
0639114,"Ladera Ranch CDP, California",121,18170,"Ladera Ranch CDP, California",238,27277,NA,NA,NA,117,NA,0.9669421487603306,NA,0.006659328563566318,0.008725299703046523,NA,0.002065971139480205,NA
0639122,"Lafayette city, California",112,23769,"Lafayette city, California",148,26305,39122,23534,135,36,13,0.32142857142857145,0.0962962962962963,0.004712019857797972,0.00562630678578217,0.005736381405625903,9.142869279841984e-4,-1.100746198437327e-4
0639178,"Laguna Beach city, California",128,22788,"Laguna Beach city, California",194,23036,39178,23242,165,66,29,0.515625,0.17575757575757575,0.00561699139898192,0.00842160097239104,0.0070992169348593065,0.00280460957340912,0.001322384037531734
0639220,"Laguna Hills city, California",241,30416,"Laguna Hills city, California",470,31617,39220,31231,430,229,40,0.950207468879668,0.09302325581395349,0.007923461336138875,0.014865420501628871,0.01376837116967116,0.006941959165489996,0.0010970493319577106
0639248,"Laguna Niguel city, California",1100,62614,"Laguna Niguel city, California",1007,65808,39248,44534,605,-93,402,-0.08454545454545455,0.6644628099173554,0.017567956048168142,0.015302090931193776,0.013585125971168096,-0.0022658651169743665,0.0017169649600256801
0639259,"Laguna Woods city, California",126,16295,"Laguna Woods city, California",114,16053,39259,15798,32,-12,82,-0.09523809523809523,2.5625,0.007732433261736729,0.0071014763595589605,0.002025572857323712,-6.309569021777685e-4,0.005075903502235249
0639283,"Lagunitas-Forest Knolls CDP, California",47,2321,"Lagunitas-Forest Knolls CDP, California",3,1771,39283,1509,11,-44,-8,-0.9361702127659575,-0.7272727272727273,0.020249892287806978,0.0016939582156973462,0.00728959575878065,-0.01855593407210963,-0.005595637543083304
0639290,"La Habra city, California",1273,59772,"La Habra city, California",841,60594,39290,51682,487,-432,354,-0.33935585231736054,0.7268993839835729,0.02129759753730844,0.013879261973132653,0.009423009945435549,-0.007418335564175786,0.004456252027697104
0639304,"La Habra Heights city, California",13,5278,"La Habra Heights city, California",6,6574,39304,5460,21,-7,-15,-0.5384615384615384,-0.7142857142857143,0.0024630541871921183,9.126863401277761e-4,0.0038461538461538464,-0.0015503678470643423,-0.0029334675060260704
0639318,"La Honda CDP, California",23,1209,"La Honda CDP, California",1,960,39318,1167,125,-22,-124,-0.9565217391304348,-0.992,0.01902398676592225,0.0010416666666666667,0.10711225364181662,-0.017982320099255582,-0.10607058697514996
0639411,"Lake Almanor Country Club CDP, California",0,768,"Lake Almanor Country Club CDP, California",0,408,39411,651,0,0,0,NA,NA,0,0,0,0,0
0639420,"Lake Almanor Peninsula CDP, California",0,260,"Lake Almanor Peninsula CDP, California",0,366,39420,333,0,0,0,NA,NA,0,0,0,0,0
0639425,"Lake Almanor West CDP, California",0,363,"Lake Almanor West CDP, California",0,224,39425,240,0,0,0,NA,NA,0,0,0,0,0
0639444,"Lake Arrowhead CDP, California",158,9578,"Lake Arrowhead CDP, California",101,8940,39444,8972,26,-57,75,-0.36075949367088606,2.8846153846153846,0.016496136980580497,0.011297539149888142,0.0028979045920642,-0.005198597830692354,0.008399634557823943
0639460,"Lake California CDP, California",13,2604,"Lake California CDP, California",21,3329,39460,758,6,8,15,0.6153846153846154,2.5,0.0049923195084485405,0.0063082006608591165,0.0079155672823219,0.001315881152410576,-0.0016073666214627838
0639472,"Lake City CDP, California",0,77,"Lake City CDP, California",4,56,39472,87,0,4,4,NA,NA,0,0.07142857142857142,0,0.07142857142857142,0.07142857142857142
0639483,"Lake Davis CDP, California",0,11,"Lake Davis CDP, California",0,52,39483,9,0,0,0,NA,NA,0,0,0,0,0
0639484,"Lake Don Pedro CDP, California",30,1337,"Lake Don Pedro CDP, California",0,901,39484,387,1,-30,-1,-1,-1,0.02243829468960359,0,0.002583979328165375,-0.02243829468960359,-0.002583979328165375
0639486,"Lake Elsinore city, California",2856,48644,"Lake Elsinore city, California",4362,65817,39486,19173,733,1506,3629,0.5273109243697479,4.9508867667121415,0.058712276950908644,0.06627467067778842,0.038230845459761124,0.007562393726879772,0.028043825218027292
0639496,"Lake Forest city, California",1425,76724,"Lake Forest city, California",1837,83974,39496,58886,1053,412,784,0.28912280701754384,0.7445394112060779,0.018573067097648714,0.021875818705789887,0.017882009306116903,0.0033027516081411724,0.003993809399672983
0639514,"Lakehead CDP, California",0,290,"Lakehead CDP, California",5,670,39514,598,1,5,4,NA,4,0,0.007462686567164179,0.0016722408026755853,0.007462686567164179,0.005790445764488594
0639556,"Lake Hughes CDP, California",29,778,"Lake Hughes CDP, California",0,520,39556,302,1,-29,-1,-1,-1,0.037275064267352186,0,0.0033112582781456954,-0.037275064267352186,-0.0033112582781456954
0639570,"Lake Isabella CDP, California",41,3287,"Lake Isabella CDP, California",0,3495,39570,3394,1,-41,-1,-1,-1,0.012473379981746273,0,2.946375957572186e-4,-0.012473379981746273,-2.946375957572186e-4
0639598,"Lakeland Village CDP, California",276,12125,"Lakeland Village CDP, California",364,13002,39598,8462,104,88,260,0.3188405797101449,2.5,0.022762886597938143,0.02799569297031226,0.01229023871425195,0.005232806372374117,0.015705454256060312
0639612,"Lake Los Angeles CDP, California",1824,12506,"Lake Los Angeles CDP, California",1040,11751,39612,11515,925,-784,115,-0.4298245614035088,0.12432432432432433,0.14584999200383816,0.0885031061186282,0.08033000434216239,-0.05734688588520996,0.00817310177646581
0639645,"Lake Mathews CDP, California",400,6002,"Lake Mathews CDP, California",295,6792,39645,4128,166,-105,129,-0.2625,0.7771084337349398,0.06664445184938354,0.04343345111896349,0.040213178294573645,-0.023211000730420053,0.0032202728243898443
0639670,"Lake Nacimiento CDP, California",0,2408,"Lake Nacimiento CDP, California",0,2981,39670,1854,10,0,-10,NA,-1,0,0,0.005393743257820928,0,-0.005393743257820928
0639690,"Lake of the Pines CDP, California",22,3638,"Lake of the Pines CDP, California",0,3599,39690,3890,1,-22,-1,-1,-1,0.006047278724573941,0,2.570694087403599e-4,-0.006047278724573941,-2.570694087403599e-4
0639696,"Lake of the Woods CDP, California",0,986,"Lake of the Woods CDP, California",0,931,39696,746,1,0,-1,NA,-1,0,0,0.0013404825737265416,0,-0.0013404825737265416
0639710,"Lakeport city, California",57,4855,"Lakeport city, California",25,4910,39710,4536,31,-32,-6,-0.5614035087719298,-0.1935483870967742,0.011740473738414007,0.0050916496945010185,0.0068342151675485005,-0.006648824043912988,-0.001742565473047482
0639715,"Lake Riverside CDP, California",12,1410,"Lake Riverside CDP, California",0,1354,39715,336,1,-12,-1,-1,-1,0.00851063829787234,0,0.002976190476190476,-0.00851063829787234,-0.002976190476190476
0639724,"Lake San Marcos CDP, California",52,4532,"Lake San Marcos CDP, California",114,4713,39724,3805,7,62,107,1.1923076923076923,15.285714285714286,0.01147396293027361,0.0241884150222788,0.0018396846254927727,0.012714452092005191,0.02234873039678603
0639735,"Lake Sherwood CDP, California",0,1388,"Lake Sherwood CDP, California",4,1677,39735,430,1,4,3,NA,3,0,0.002385211687537269,0.002325581395348837,0.002385211687537269,5.963029218843162e-5
0639766,"Lakeside CDP, California",296,20505,"Lakeside CDP, California",370,21917,39766,18308,141,74,229,0.25,1.624113475177305,0.014435503535722994,0.01688187251904914,0.007701551234433035,0.0024463689833261453,0.009180321284616105
0639836,"Lakeview CDP, California",9,1426,"Lakeview CDP, California",0,2638,39836,1448,16,-9,-16,-1,-1,0.006311360448807854,0,0.011049723756906077,-0.006311360448807854,-0.011049723756906077
0639885,"Lake Wildwood CDP, California",0,5416,"Lake Wildwood CDP, California",1,5232,39885,4458,7,1,-6,NA,-0.8571428571428571,0,1.9113149847094801e-4,0.0015702108568864963,1.9113149847094801e-4,-0.0013790793584155482
0639892,"Lakewood city, California",6257,79859,"Lakewood city, California",7274,80292,39892,73575,2712,1017,4562,0.16253795748761388,1.6821533923303835,0.07835059292002154,0.09059433069297065,0.03686034658511723,0.012243737772949112,0.053733984107853426
0640004,"La Mesa city, California",3948,56250,"La Mesa city, California",4820,59556,40004,52965,1589,872,3231,0.22087132725430597,2.0333543108873506,0.07018666666666666,0.08093223184901605,0.030000944019635607,0.010745565182349384,0.05093128782938044
0640032,"La Mirada city, California",929,48174,"La Mirada city, California",883,48764,40032,40452,562,-46,321,-0.04951560818083961,0.5711743772241993,0.01928426121974509,0.018107620375686983,0.013893008998318995,-0.0011766408440581078,0.004214611377367988
0640088,"Lamont CDP, California",26,15365,"Lamont CDP, California",0,14799,40088,11215,18,-26,-18,-1,-1,0.0016921575008135372,0,0.0016049933125278646,-0.0016921575008135372,-0.0016049933125278646
0640116,"Lanare CDP, California",0,576,"Lanare CDP, California",0,226,40116,353,151,0,-151,NA,-1,0,0,0.42776203966005666,0,-0.42776203966005666
0640130,"Lancaster city, California",28787,149709,"Lancaster city, California",33442,159028,40130,97320,7207,4655,26235,0.16170493625594887,3.6402109060635492,0.19228636888897796,0.21029001182181753,0.07405466502260584,0.01800364293283957,0.13623534679921168
0640256,"La Palma city, California",799,15479,"La Palma city, California",718,15604,40256,15392,642,-81,76,-0.10137672090112641,0.11838006230529595,0.051618321597002394,0.0460138426044604,0.04170997920997921,-0.005604478992541996,0.004303863394481189
0640312,"La Porte CDP, California",0,36,"La Porte CDP, California",0,0,40312,74,0,0,0,NA,NA,0,NA,0,NA,NA
0640326,"La Presa CDP, California",4790,34885,"La Presa CDP, California",4323,38227,40326,30718,3354,-467,969,-0.09749478079331941,0.2889087656529517,0.13730829869571448,0.11308760823501714,0.10918679601536559,-0.024220690460697344,0.0039008122196515504
0640340,"La Puente city, California",345,40075,"La Puente city, California",358,40020,40340,36972,1308,13,-950,0.03768115942028986,-0.7262996941896025,0.008608858390517778,0.00894552723638181,0.03537812398571892,3.3666884586403163e-4,-0.02643259674933711
0640354,"La Quinta city, California",779,35661,"La Quinta city, California",809,41076,40354,11539,206,30,603,0.038510911424903725,2.9271844660194173,0.021844592131460137,0.019695199143051904,0.017852500216656558,-0.0021493929884082337,0.001842698926395346
0640410,"La Riviera CDP, California",1353,11148,"La Riviera CDP, California",1299,10840,40410,11814,771,-54,528,-0.03991130820399113,0.6848249027237354,0.12136706135629709,0.1198339483394834,0.06526155408836973,-0.001533113016813692,0.05457239425111367
0640426,"Larkfield-Wikiup CDP, California",36,8641,"Larkfield-Wikiup CDP, California",0,8312,40426,7784,45,-36,-45,-1,-1,0.004166184469390117,0,0.005781089414182939,-0.004166184469390117,-0.005781089414182939
0640438,"Larkspur city, California",148,11804,"Larkspur city, California",88,12319,40438,11092,88,-60,0,-0.40540540540540543,0,0.01253812267028126,0.007143436967286305,0.007933645870897944,-0.0053946857029949545,-7.902089036116383e-4
0640508,"La Selva Beach CDP, California",19,2552,"La Selva Beach CDP, California",8,2679,40508,3349,22,-11,-14,-0.5789473684210527,-0.6363636363636364,0.007445141065830721,0.0029861888764464353,0.006569125111973723,-0.0044589521893842856,-0.003582936235527288
0640526,"Las Flores CDP (Orange County), California",36,6270,"Las Flores CDP (Orange County), California",0,5861,40526,14,0,-36,0,-1,NA,0.005741626794258373,0,0,-0.005741626794258373,0
0640536,"Las Flores CDP (Tehama County), California",0,98,"Las Flores CDP (Tehama County), California",0,361,40536,168,2,0,-2,NA,-1,0,0,0.011904761904761904,0,-0.011904761904761904
0640592,"Las Lomas CDP, California",0,2695,"Las Lomas CDP, California",0,2924,40592,2127,4,0,-4,NA,-1,0,0,0.0018805829807240243,0,-0.0018805829807240243
0640704,"Lathrop city, California",868,17040,"Lathrop city, California",1415,22341,40704,7641,209,547,1206,0.630184331797235,5.770334928229665,0.05093896713615023,0.0633364665860973,0.027352440780002617,0.012397499449947072,0.03598402580609469
0640746,"Laton CDP, California",0,1385,"Laton CDP, California",0,2000,40746,1437,9,0,-9,NA,-1,0,0,0.006263048016701462,0,-0.006263048016701462
0640830,"La Verne city, California",1521,31177,"La Verne city, California",1062,32211,40830,31378,976,-459,86,-0.30177514792899407,0.08811475409836066,0.04878596401193187,0.03297010338083264,0.031104595576518578,-0.015815860631099236,0.0018655078043140587
0640872,"La Vina CDP, California",0,810,"La Vina CDP, California",0,211,40872,303,0,0,0,NA,NA,0,0,0,0,0
0640886,"Lawndale city, California",2354,32552,"Lawndale city, California",3352,32819,40886,27340,2273,998,1079,0.4239592183517417,0.4747030356357237,0.07231506512656673,0.10213595782930619,0.08313825896122896,0.029820892702739465,0.01899769886807723
0640928,"Laytonville CDP, California",0,1275,"Laytonville CDP, California",7,1198,40928,1133,13,7,-6,NA,-0.46153846153846156,0,0.005843071786310518,0.01147396293027361,0.005843071786310518,-0.005630891143963093
0640956,"Lebec CDP, California",0,1619,"Lebec CDP, California",0,1472,40956,1429,3,0,-3,NA,-1,0,0,0.002099370188943317,0,-0.002099370188943317
0640998,"Lee Vining CDP, California",0,333,"Lee Vining CDP, California",5,98,40998,254,3,5,2,NA,0.6666666666666666,0,0.05102040816326531,0.011811023622047244,0.05102040816326531,0.03920938454121806
0641026,"Leggett CDP, California",0,68,"Leggett CDP, California",0,83,41026,114,2,0,-2,NA,-1,0,0,0.017543859649122806,0,-0.017543859649122806
0641040,"Le Grand CDP, California",0,1818,"Le Grand CDP, California",16,1739,41040,1168,1,16,15,NA,15,0,0.009200690051753882,8.561643835616438e-4,0.009200690051753882,0.008344525668192238
0641110,"Lemon Cove CDP, California",18,156,"Lemon Cove CDP, California",0,232,41110,411,1,-18,-1,-1,-1,0.11538461538461539,0,0.0024330900243309003,-0.11538461538461539,-0.0024330900243309003
0641124,"Lemon Grove city, California",2845,25074,"Lemon Grove city, California",4018,26802,41124,23984,1920,1173,2098,0.41230228471001756,1.0927083333333334,0.11346414612746271,0.14991418550854413,0.0800533689126084,0.03645003938108142,0.06986081659593572
0641142,"Lemon Hill CDP, California",1479,13424,"Lemon Hill CDP, California",1715,14733,41142,12435,1752,236,-37,0.15956727518593644,-0.021118721461187213,0.11017580452920143,0.11640534853729723,0.14089264173703256,0.0062295440080957915,-0.024487293199735333
0641152,"Lemoore city, California",2185,23901,"Lemoore city, California",1509,26107,41152,14280,812,-676,697,-0.3093821510297483,0.8583743842364532,0.09141876908915945,0.057800589880108784,0.056862745098039215,-0.03361817920905067,9.37844782069569e-4
0641166,"Lemoore Station CDP, California",810,7890,"Lemoore Station CDP, California",1138,6858,NA,NA,NA,328,NA,0.4049382716049383,NA,0.10266159695817491,0.16593759113444154,NA,0.06327599417626663,NA
0641180,"Lennox CDP, California",1157,21594,"Lennox CDP, California",827,21818,41180,22807,1451,-330,-624,-0.28522039757994816,-0.43004824259131635,0.05357969806427711,0.03790448253735448,0.06362081816986014,-0.015675215526922637,-0.02571633563250566
0641194,"Lenwood CDP, California",275,3454,"Lenwood CDP, California",227,4122,41194,2926,74,-48,153,-0.17454545454545456,2.0675675675675675,0.07961783439490445,0.05507035419699175,0.025290498974709502,-0.024547480197912704,0.02977985522228225
0641208,"Leona Valley CDP, California",0,1617,"Leona Valley CDP, California",16,1571,41208,1549,13,16,3,NA,0.23076923076923078,0,0.010184595798854232,0.008392511297611363,0.010184595798854232,0.0017920845012428695
0641278,"Lewiston CDP, California",0,1242,"Lewiston CDP, California",64,1383,41278,1187,3,64,61,NA,20.333333333333332,0,0.046276211135213303,0.002527379949452401,0.046276211135213303,0.0437488311857609
0641282,"Lexington Hills CDP, California",10,2378,"Lexington Hills CDP, California",3,2685,41282,2113,9,-7,-6,-0.7,-0.6666666666666666,0.004205214465937763,0.0011173184357541898,0.004259346900141978,-0.0030878960301835732,-0.0031420284643877885
0641390,"Likely CDP, California",0,63,"Likely CDP, California",0,0,41390,55,0,0,0,NA,NA,0,NA,0,NA,NA
0641474,"Lincoln city, California",863,37771,"Lincoln city, California",761,47388,41474,7445,14,-102,747,-0.11819235225955968,53.357142857142854,0.022848216885970718,0.016058917869502826,0.001880456682337139,-0.006789299016467892,0.014178461187165687
0641558,"Lincoln Village CDP, California",114,4475,"Lincoln Village CDP, California",92,4859,41558,4236,99,-22,-7,-0.19298245614035087,-0.0707070707070707,0.02547486033519553,0.01893393702407903,0.023371104815864022,-0.006540923311116501,-0.004437167791784994
0641572,"Linda CDP, California",288,17406,"Linda CDP, California",1104,20228,41572,13819,403,816,701,2.8333333333333335,1.739454094292804,0.016546018614270942,0.05457781293256872,0.02916274694261524,0.03803179431829778,0.02541506598995348
0641656,"Lindcove CDP, California",0,476,"Lindcove CDP, California",0,287,41656,408,0,0,0,NA,NA,0,0,0,0,0
0641670,"Linden CDP, California",20,1901,"Linden CDP, California",0,1547,41670,1339,9,-20,-9,-1,-1,0.010520778537611783,0,0.006721433905899925,-0.010520778537611783,-0.006721433905899925
0641712,"Lindsay city, California",24,11528,"Lindsay city, California",56,13310,41712,8466,5,32,51,1.3333333333333333,10.2,0.002081887578070784,0.0042073628850488355,5.905976848570753e-4,0.0021254753069780514,0.00361676520019176
0641740,"Linnell Camp CDP, California",0,650,"Linnell Camp CDP, California",0,928,41740,997,0,0,0,NA,NA,0,0,0,0,0
0641782,"Litchfield CDP, California",0,103,"Litchfield CDP, California",0,205,41782,262,0,0,0,NA,NA,0,0,0,0,0
0641789,"Little Grass Valley CDP, California",0,23,"Little Grass Valley CDP, California",0,0,41789,1,0,0,0,NA,NA,0,NA,0,NA,NA
0641866,"Little River CDP, California",0,290,"Little River CDP, California",0,212,41866,27,0,0,0,NA,NA,0,0,0,0,0
0641880,"Littlerock CDP, California",30,1063,"Littlerock CDP, California",0,786,41880,1330,53,-30,-53,-1,-1,0.028222013170272814,0,0.03984962406015038,-0.028222013170272814,-0.03984962406015038
0641922,"Live Oak CDP, California",140,16439,"Live Oak CDP, California",101,16837,41922,15182,235,-39,-134,-0.2785714285714286,-0.5702127659574469,0.008516333110286513,0.005998693353922908,0.015478856540640231,-0.0025176397563636058,-0.009480163186717324
0641936,"Live Oak city, California",62,8129,"Live Oak city, California",195,8679,41936,4611,43,133,152,2.1451612903225805,3.5348837209302326,0.007627014392914257,0.02246802627030764,0.00932552591628714,0.014841011877393381,0.0131425003540205
0641992,"Livermore city, California",1525,78520,"Livermore city, California",1629,89699,41992,57487,866,104,763,0.06819672131147542,0.8810623556581986,0.019421803362200712,0.01816073757789942,0.015064275401395098,-0.0012610657843012928,0.003096462176504321
0642006,"Livingston city, California",124,12733,"Livingston city, California",17,14228,42006,7519,55,-107,-38,-0.8629032258064516,-0.6909090909090909,0.00973847482918401,0.0011948271014900196,0.007314802500332491,-0.00854364772769399,-0.006119975398842472
0642104,"Lockeford CDP, California",0,3489,"Lockeford CDP, California",3,3521,42104,2746,4,3,-1,NA,-0.25,0,8.520306731042318e-4,0.0014566642388929353,8.520306731042318e-4,-6.046335657887035e-4
0642146,"Lockwood CDP, California",15,200,"Lockwood CDP, California",0,516,42146,235,10,-15,-10,-1,-1,0.075,0,0.0425531914893617,-0.075,-0.0425531914893617
0642202,"Lodi city, California",929,62225,"Lodi city, California",1210,65846,42202,52290,171,281,1039,0.302475780409042,6.076023391812866,0.014929690638810767,0.018376211159371866,0.003270223752151463,0.0034465205205610992,0.015105987407220403
0642230,"Lodoga CDP, California",6,222,"Lodoga CDP, California",67,168,42230,120,7,61,60,10.166666666666666,8.571428571428571,0.02702702702702703,0.39880952380952384,0.058333333333333334,0.3717824967824968,0.3404761904761905
0642328,"Loleta CDP, California",0,844,"Loleta CDP, California",26,632,42328,635,0,26,26,NA,NA,0,0.04113924050632911,0,0.04113924050632911,0.04113924050632911
0642370,"Loma Linda city, California",1120,22837,"Loma Linda city, California",2606,24184,42370,18888,1254,1486,1352,1.3267857142857142,1.0781499202551834,0.04904321933704077,0.10775719483956335,0.06639135959339262,0.05871397550252258,0.041365835246170726
0642384,"Loma Mar CDP, California",0,61,"Loma Mar CDP, California",0,172,42384,116,1,0,-1,NA,-1,0,0,0.008620689655172414,0,-0.008620689655172414
0642412,"Loma Rica CDP, California",0,2844,"Loma Rica CDP, California",238,3178,42412,1852,13,238,225,NA,17.307692307692307,0,0.07488986784140969,0.007019438444924406,0.07488986784140969,0.06787042939648529
0642468,"Lomita city, California",515,20186,"Lomita city, California",1285,20514,42468,19132,547,770,738,1.4951456310679612,1.3491773308957953,0.02551273159615575,0.06264014819147899,0.028590842567426302,0.037127416595323245,0.034049305624052686
0642510,"Lompico CDP, California",41,1037,"Lompico CDP, California",28,1035,42510,1252,8,-13,20,-0.3170731707317073,2.5,0.03953712632594021,0.02705314009661836,0.006389776357827476,-0.012483986229321852,0.020663363738790883
0642524,"Lompoc city, California",2730,41864,"Lompoc city, California",1992,43232,42524,37685,2954,-738,-962,-0.2703296703296703,-0.3256601218686527,0.0652111599464934,0.04607698001480385,0.07838662597850604,-0.019134179931689553,-0.03230964596370219
0642566,"London CDP, California",0,1801,"London CDP, California",24,1690,42566,1638,11,24,13,NA,1.1818181818181819,0,0.014201183431952662,0.006715506715506716,0.014201183431952662,0.007485676716445946
0642580,"Lone Pine CDP, California",15,2309,"Lone Pine CDP, California",2,1807,42580,2062,8,-13,-6,-0.8666666666666667,-0.75,0.0064963187527068,0.0011068068622025456,0.0038797284190106693,-0.005389511890504254,-0.0027729215568081237
0642622,"Long Barn CDP, California",0,187,"Long Barn CDP, California",0,102,42622,140,0,0,0,NA,NA,0,0,0,0,0
0643000,"Long Beach city, California",61011,461823,"Long Beach city, California",59126,466776,43000,429441,58761,-1885,365,-0.03089606792217797,0.006211602933918756,0.13210905476773568,0.12666889471609508,0.13683136915199062,-0.005440160051640608,-0.010162474435895547
0643126,"Lookout CDP, California",0,25,"Lookout CDP, California",0,44,43126,84,0,0,0,NA,NA,0,0,0,0,0
0643140,"Loomis town, California",14,6501,"Loomis town, California",33,6790,43140,5725,23,19,10,1.3571428571428572,0.43478260869565216,0.002153514843870174,0.0048600883652430045,0.004017467248908297,0.0027065735213728306,8.426211163347075e-4
0643224,"Los Alamitos city, California",368,11414,"Los Alamitos city, California",713,11534,43224,11672,348,345,365,0.9375,1.0488505747126438,0.032241107411950236,0.0618172359979192,0.02981494174091844,0.02957612858596896,0.032002294257000755
0643252,"Los Alamos CDP, California",0,1252,"Los Alamos CDP, California",31,1634,43252,1174,2,31,29,NA,14.5,0,0.018971848225214197,0.0017035775127768314,0.018971848225214197,0.017268270712437365
0643280,"Los Altos city, California",54,28409,"Los Altos city, California",145,30504,43280,26770,111,91,34,1.6851851851851851,0.3063063063063063,0.0019008060825794642,0.004753474954104379,0.004146432573776616,0.002852668871524915,6.070423803277636e-4
0643294,"Los Altos Hills town, California",14,7858,"Los Altos Hills town, California",65,8505,43294,8023,61,51,4,3.642857142857143,0.06557377049180328,0.0017816238228556885,0.007642563198118754,0.0076031409697120775,0.005860939375263065,3.942222840667628e-5
0644000,"Los Angeles city, California",367515,3772486,"Los Angeles city, California",354169,3966936,44000,3486465,487810,-13346,-133641,-0.036314164047725944,-0.2739611734076792,0.09741984463295557,0.08928024046770607,0.13991535839310018,-0.008139604165249503,-0.050635117925394116
0644028,"Los Banos city, California",1509,34548,"Los Banos city, California",1042,38914,44028,14814,392,-467,650,-0.30947647448641485,1.6581632653061225,0.04367836054185481,0.026776995425810763,0.026461455380045903,-0.016901365116044047,3.155400457648602e-4
0644042,"Los Berros CDP, California",0,616,"Los Berros CDP, California",2,528,44042,532,0,2,2,NA,NA,0,0.003787878787878788,0,0.003787878787878788,0.003787878787878788
0644112,"Los Gatos town, California",467,28878,"Los Gatos town, California",284,30729,44112,27641,199,-183,85,-0.39186295503211993,0.4271356783919598,0.016171480019391924,0.009242084024862507,0.00719945009225426,-0.006929395994529417,0.002042633932608247
0644140,"Los Molinos CDP, California",0,2345,"Los Molinos CDP, California",0,1746,44140,1709,0,0,0,NA,NA,0,0,0,0,0
0644168,"Los Olivos CDP, California",0,905,"Los Olivos CDP, California",0,791,44168,1089,0,0,0,NA,NA,0,0,0,0,0
0644182,"Los Osos CDP, California",70,14924,"Los Osos CDP, California",31,16533,44182,14756,118,-39,-87,-0.5571428571428572,-0.7372881355932204,0.004690431519699813,0.0018750378031815158,0.007996747085931146,-0.002815393716518297,-0.0061217092827496305
0644242,"Los Ranchos CDP, California",0,1519,"Los Ranchos CDP, California",0,1639,44242,1276,1,0,-1,NA,-1,0,0,7.836990595611285e-4,0,-7.836990595611285e-4
0644280,"Lost Hills CDP, California",0,2143,"Lost Hills CDP, California",0,1726,44280,1247,0,0,0,NA,NA,0,0,0,0,0
0644350,"Lower Lake CDP, California",0,1247,"Lower Lake CDP, California",0,1355,44350,1163,24,0,-24,NA,-1,0,0,0.02063628546861565,0,-0.02063628546861565
0644364,"Loyalton city, California",5,892,"Loyalton city, California",1,1093,44364,975,6,-4,-5,-0.8,-0.8333333333333334,0.005605381165919282,9.149130832570906e-4,0.006153846153846154,-0.004690468082662192,-0.0052389330705890635
0644378,"Loyola CDP, California",0,3316,"Loyola CDP, California",5,3367,44378,2872,9,5,-4,NA,-0.4444444444444444,0,0.001485001485001485,0.0031337047353760445,0.001485001485001485,-0.0016487032503745595
0644399,"Lucas Valley-Marinwood CDP, California",92,6322,"Lucas Valley-Marinwood CDP, California",7,6686,44399,5984,72,-85,-65,-0.9239130434782609,-0.9027777777777778,0.014552356849098386,0.0010469638049655997,0.012032085561497326,-0.013505393044132787,-0.010985121756531727
0644406,"Lucerne CDP, California",107,2680,"Lucerne CDP, California",108,2896,44406,2605,31,1,77,0.009345794392523364,2.4838709677419355,0.03992537313432836,0.03729281767955801,0.011900191938579654,-0.002632555454770348,0.025392625740978357
0644420,"Lucerne Valley CDP, California",425,5613,"Lucerne Valley CDP, California",136,5956,44420,4209,58,-289,78,-0.68,1.3448275862068966,0.07571708533760912,0.022834116856950974,0.0137799952482775,-0.052882968480658155,0.009054121608673473
0644574,"Lynwood city, California",8278,69806,"Lynwood city, California",5730,70635,44574,62086,14657,-2548,-8927,-0.3078038173471853,-0.6090605171590366,0.11858579491734235,0.08112125716712677,0.23607576587314372,-0.037464537750215576,-0.15495450870601696
0644644,"Lytle Creek CDP, California",0,740,"Lytle Creek CDP, California",0,673,44644,604,4,0,-4,NA,-1,0,0,0.006622516556291391,0,-0.006622516556291391
0644672,"Mabie CDP, California",0,165,"Mabie CDP, California",0,25,44672,65,1,0,-1,NA,-1,0,0,0.015384615384615385,0,-0.015384615384615385
0644700,"McArthur CDP, California",0,215,"McArthur CDP, California",0,446,44700,429,0,0,0,NA,NA,0,0,0,0,0
0644760,"McClellan Park CDP, California",170,999,"McClellan Park CDP, California",320,1046,44760,558,92,150,228,0.8823529411764706,2.4782608695652173,0.17017017017017017,0.30592734225621415,0.16487455197132617,0.135757172086044,0.14105279028488799
0644770,"McClenney Tract CDP, California",0,0,"McClenney Tract CDP, California",0,47,NA,NA,NA,0,NA,NA,NA,NA,0,NA,NA,NA
0644784,"McCloud CDP, California",9,1210,"McCloud CDP, California",11,1020,44784,1555,18,2,-7,0.2222222222222222,-0.3888888888888889,0.00743801652892562,0.010784313725490196,0.01157556270096463,0.003346297196564576,-7.912489754744335e-4
0644812,"Macdoel CDP, California",0,147,"Macdoel CDP, California",0,54,44812,182,1,0,-1,NA,-1,0,0,0.005494505494505495,0,-0.005494505494505495
0644826,"McFarland city, California",147,12302,"McFarland city, California",161,14823,44826,7005,12,14,149,0.09523809523809523,12.416666666666666,0.011949276540399935,0.01086149902179046,0.0017130620985010706,-0.0010877775186094747,0.009148436923289389
0644830,"McGee Creek CDP, California",0,29,"McGee Creek CDP, California",0,0,NA,NA,NA,0,NA,NA,NA,0,NA,NA,NA,NA
0644910,"McKinleyville CDP, California",19,16896,"McKinleyville CDP, California",59,17208,44910,10567,41,40,18,2.1052631578947367,0.43902439024390244,0.0011245265151515152,0.0034286378428637844,0.0038800037853695467,0.002304111327712269,-4.5136594250576225e-4
0644924,"McKittrick CDP, California",0,109,"McKittrick CDP, California",1,116,44924,162,0,1,1,NA,NA,0,0.008620689655172414,0,0.008620689655172414,0.008620689655172414
0645006,"McSwain CDP, California",7,3992,"McSwain CDP, California",170,4399,45006,2139,52,163,118,23.285714285714285,2.269230769230769,0.0017535070140280561,0.03864514662423278,0.02431042543244507,0.036891639610204724,0.014334721191787712
0645022,"Madera city, California",2041,59006,"Madera city, California",2555,64833,45022,30085,1398,514,1157,0.2518373346398824,0.8276108726752504,0.034589702742094025,0.03940894297657058,0.04646833970417152,0.004819240234476552,-0.00705939672760094
0645050,"Madera Acres CDP, California",341,9065,"Madera Acres CDP, California",204,9857,45050,5239,164,-137,40,-0.40175953079178883,0.24390243902439024,0.037617209045780475,0.020695952115248047,0.03130368390914297,-0.016921256930532428,-0.01060773179389492
0645064,"Madison CDP, California",0,492,"Madison CDP, California",1,581,45064,474,6,1,-5,NA,-0.8333333333333334,0,0.0017211703958691911,0.012658227848101266,0.0017211703958691911,-0.010937057452232075
0645092,"Mad River CDP, California",0,366,"Mad River CDP, California",0,458,45092,354,0,0,0,NA,NA,0,0,0,0,0
0645120,"Magalia CDP, California",34,11640,"Magalia CDP, California",5,11476,45120,8904,11,-29,-6,-0.8529411764705882,-0.5454545454545454,0.002920962199312715,4.35691878703381e-4,0.0012353998203054807,-0.0024852703206093337,-7.997079416020998e-4
0645232,"Malaga CDP, California",0,824,"Malaga CDP, California",11,1186,45232,843,0,11,11,NA,NA,0,0.00927487352445194,0,0.00927487352445194,0.00927487352445194
0645246,"Malibu city, California",175,12794,"Malibu city, California",133,12620,45246,12648,137,-42,-4,-0.24,-0.029197080291970802,0.013678286696889167,0.010538827258320126,0.010831752055660974,-0.003139459438569041,-2.929247973408478e-4
0645358,"Mammoth Lakes town, California",99,8005,"Mammoth Lakes town, California",76,8169,45358,4785,9,-23,67,-0.23232323232323232,7.444444444444445,0.012367270455965022,0.009303464316317787,0.0018808777429467085,-0.0030638061396472353,0.007422586573371078
0645386,"Manchester CDP, California",0,222,"Manchester CDP, California",0,218,45386,184,0,0,0,NA,NA,0,0,0,0,0
0645400,"Manhattan Beach city, California",109,34867,"Manhattan Beach city, California",191,35500,45400,32063,206,82,-15,0.7522935779816514,-0.07281553398058252,0.003126165141824648,0.005380281690140845,0.0064248510744471824,0.002254116548316197,-0.0010445693843063372
0645414,"Manila CDP, California",0,887,"Manila CDP, California",9,793,45414,827,5,9,4,NA,0.8,0,0.011349306431273645,0.006045949214026602,0.011349306431273645,0.005303357217247043
0645484,"Manteca city, California",2206,64959,"Manteca city, California",3808,79129,45484,42452,635,1602,3173,0.7262012692656392,4.996850393700788,0.03395988238735202,0.04812394950018325,0.01495807029115236,0.014164067112831226,0.033165879209030885
0645512,"Manton CDP, California",7,286,"Manton CDP, California",0,350,45512,396,1,-7,-1,-1,-1,0.024475524475524476,0,0.0025252525252525255,-0.024475524475524476,-0.0025252525252525255
0645680,"March ARB CDP, California",38,843,"March ARB CDP, California",55,989,45680,5751,1142,17,-1087,0.4473684210526316,-0.9518388791593695,0.045077105575326216,0.055611729019211326,0.19857416101547556,0.010534623443885109,-0.14296243199626424
0645736,"Maricopa city, California",9,1205,"Maricopa city, California",0,1229,45736,1197,2,-9,-2,-1,-1,0.007468879668049793,0,0.001670843776106934,-0.007468879668049793,-0.001670843776106934
0645778,"Marina city, California",1642,19529,"Marina city, California",1474,21981,45778,26436,5016,-168,-3542,-0.1023142509135201,-0.706140350877193,0.08408008602591019,0.06705791365270006,0.18974126191556967,-0.01702217237321013,-0.12268334826286961
0645806,"Marina del Rey CDP, California",674,9196,"Marina del Rey CDP, California",788,9852,45806,7250,308,114,480,0.16913946587537093,1.5584415584415585,0.07329273597216181,0.079983759642712135,0.042482758620689655,0.006691023670550328,0.03750100102202248
0645820,"Marin City CDP, California",1147,2825,"Marin City CDP, California",688,3126,45820,2077,1191,-459,-503,-0.4001743679163034,-0.42233417296389586,0.40601769911504426,0.2200895713371721,0.5734232065479057,-0.18592812777787215,-0.3533336352107336
0645932,"Mariposa CDP, California",0,2122,"Mariposa CDP, California",16,1186,45932,1807,4,16,12,NA,3,0,0.013490725126475547,0.002213613724405091,0.013490725126475547,0.011277111402070456
0645988,"Markleeville CDP, California",0,274,"Markleeville CDP, California",0,132,45988,147,0,0,0,NA,NA,0,0,0,0,0
0646100,"Martell CDP, California",0,153,"Martell CDP, California",0,400,46100,222,0,0,0,NA,NA,0,0,0,0,0
0646114,"Martinez city, California",1465,35622,"Martinez city, California",1296,38290,46114,33695,1072,-169,224,-0.11535836177474403,0.208955223880597,0.04112627028240975,0.033846957430138415,0.031814809318890046,-0.007279312852271333,0.002032148111248369
0646170,"Marysville city, California",797,12295,"Marysville city, California",264,12327,46170,12324,637,-533,-373,-0.6687578419071518,-0.5855572998430141,0.0648230988206588,0.02141640301776588,0.05168776371308017,-0.04340669580289292,-0.03027136069531429
0646223,"Matheny CDP, California",95,1183,"Matheny CDP, California",51,1137,46223,889,65,-44,-14,-0.4631578947368421,-0.2153846153846154,0.08030431107354184,0.044854881266490766,0.07311586051743532,-0.035449429807051076,-0.028260979250944555
0646226,"Mather CDP, California",404,4498,"Mather CDP, California",346,4272,46226,543,43,-58,303,-0.14356435643564355,7.046511627906977,0.08981769675411294,0.08099250936329588,0.07918968692449356,-0.008825187390817057,0.0018028224388023234
0646338,"Maxwell CDP, California",0,849,"Maxwell CDP, California",0,1076,46338,1052,0,0,0,NA,NA,0,0,0,0,0
0646400,"Mayfair CDP, California",186,4046,"Mayfair CDP, California",406,4950,46400,3840,73,220,333,1.1827956989247312,4.561643835616438,0.04597132970835393,0.08202020202020202,0.019010416666666665,0.03604887231184809,0.06300978535353535
0646436,"Mayflower Village CDP, California",82,5918,"Mayflower Village CDP, California",31,5873,46436,5038,71,-51,-40,-0.6219512195121951,-0.5633802816901409,0.013856032443393038,0.005278392644304444,0.01409289400555776,-0.008577639799088595,-0.008814501361253318
0646492,"Maywood city, California",199,27515,"Maywood city, California",241,27332,46492,27850,114,42,127,0.21105527638190955,1.1140350877192982,0.007232418680719607,0.008817503292843554,0.004093357271095153,0.0015850846121239466,0.004724146021748401
0646520,"Meadowbrook CDP, California",174,2731,"Meadowbrook CDP, California",73,3414,46520,2293,140,-101,-67,-0.5804597701149425,-0.4785714285714286,0.06371292566825339,0.021382542472173402,0.06105538595726123,-0.042330383196079985,-0.03967284348508783
0646618,"Meadow Valley CDP, California",63,674,"Meadow Valley CDP, California",0,420,46618,555,1,-63,-1,-1,-1,0.09347181008902077,0,0.0018018018018018018,-0.09347181008902077,-0.0018018018018018018
0646632,"Meadow Vista CDP, California",22,3411,"Meadow Vista CDP, California",0,3679,46632,3044,3,-22,-3,-1,-1,0.006449721489299325,0,9.855453350854138e-4,-0.006449721489299325,-9.855453350854138e-4
0646646,"Mead Valley CDP, California",1734,17616,"Mead Valley CDP, California",1883,20145,46646,9733,2589,149,-706,0.08592848904267589,-0.2726921591348011,0.09843324250681199,0.09347232563911641,0.2660022603513819,-0.004960916867695578,-0.17252993471226552
0646660,"Mecca CDP, California",0,7872,"Mecca CDP, California",0,6635,46660,2832,0,0,0,NA,NA,0,0,0,0,0
0646702,"Meiners Oaks CDP, California",19,3521,"Meiners Oaks CDP, California",18,3569,46702,3329,6,-1,12,-0.05263157894736842,2,0.005396194262993468,0.0050434295320818156,0.0018023430459597476,-3.527647309116526e-4,0.0032410864861220677
0646814,"Mendocino CDP, California",0,1004,"Mendocino CDP, California",0,855,46814,896,4,0,-4,NA,-1,0,0,0.004464285714285714,0,-0.004464285714285714
0646828,"Mendota city, California",57,10459,"Mendota city, California",0,11531,46828,6821,98,-57,-98,-1,-1,0.005449851802275552,0,0.01436739481014514,-0.005449851802275552,-0.01436739481014514
0646842,"Menifee city, California",4221,72494,"Menifee city, California",5443,90349,46842,28592,363,1222,5080,0.28950485666903575,13.994490358126722,0.05822550831792976,0.060244164296229065,0.012695858981533296,0.002018655978299304,0.04754830531469577
0646870,"Menlo Park city, California",1871,31318,"Menlo Park city, California",1543,34138,46870,28403,3467,-328,-1924,-0.17530732228754678,-0.5549466397461783,0.059742001404942846,0.04519889858808366,0.12206457064394606,-0.014543102816859187,-0.0768656720558624
0646884,"Mentone CDP, California",658,8854,"Mentone CDP, California",373,9793,46884,5859,155,-285,218,-0.4331306990881459,1.4064516129032258,0.07431669302010391,0.03808843051158991,0.026455026455026454,-0.036228262508514,0.011633404056563455
0646898,"Merced city, California",5042,77080,"Merced city, California",4468,82662,46898,57147,3886,-574,582,-0.11384371281237604,0.14976839938239836,0.06541255838090296,0.05405143838765092,0.06800006999492537,-0.011361119993252039,-0.013948631607274456
0646926,"Meridian CDP, California",0,400,"Meridian CDP, California",11,371,46926,423,0,11,11,NA,NA,0,0.029649595687331536,0,0.029649595687331536,0.029649595687331536
0647013,"Mesa CDP, California",0,368,"Mesa CDP, California",0,348,47013,174,0,0,0,NA,NA,0,0,0,0,0
0647066,"Mesa Verde CDP, California",22,940,"Mesa Verde CDP, California",0,913,47066,891,4,-22,-4,-1,-1,0.023404255319148935,0,0.004489337822671156,-0.023404255319148935,-0.004489337822671156
0647086,"Mesa Vista CDP, California",0,203,"Mesa Vista CDP, California",0,228,47086,152,0,0,0,NA,NA,0,0,0,0,0
0647164,"Mettler CDP, California",0,102,"Mettler CDP, California",0,157,47164,81,0,0,0,NA,NA,0,0,0,0,0
0647192,"Mexican Colony CDP, California",0,139,"Mexican Colony CDP, California",0,423,47192,304,0,0,0,NA,NA,0,0,0,0,0
0647332,"Middletown CDP, California",68,1646,"Middletown CDP, California",0,739,47332,919,1,-68,-1,-1,-1,0.041312272174969626,0,0.001088139281828074,-0.041312272174969626,-0.001088139281828074
0647374,"Midpines CDP, California",6,851,"Midpines CDP, California",133,1427,47374,1021,6,127,127,21.166666666666668,21.166666666666668,0.007050528789659225,0.09320252277505256,0.005876591576885406,0.08615199398539333,0.08732593119816716
0647430,"Midway City CDP, California",0,7804,"Midway City CDP, California",24,8343,47430,6465,60,24,-36,NA,-0.6,0,0.002876663070837828,0.009280742459396751,0.002876663070837828,-0.006404079388558923
0647472,"Milford CDP, California",0,47,"Milford CDP, California",0,206,47472,239,5,0,-5,NA,-1,0,0,0.02092050209205021,0,-0.02092050209205021
0647486,"Millbrae city, California",415,21007,"Millbrae city, California",155,22625,47486,20440,235,-260,-80,-0.6265060240963856,-0.3404255319148936,0.019755319655352977,0.0068508287292817676,0.01149706457925636,-0.01290449092607121,-0.004646235849974592
0647710,"Mill Valley city, California",217,13702,"Mill Valley city, California",167,14330,47710,13097,183,-50,-16,-0.2304147465437788,-0.08743169398907104,0.01583710407239819,0.01165387299371947,0.013972665495915096,-0.004183231078678719,-0.0023187925021956254
0647724,"Millville CDP, California",2,768,"Millville CDP, California",0,678,47724,592,0,-2,0,-1,NA,0.0026041666666666665,0,0,-0.0026041666666666665,0
0647766,"Milpitas city, California",2079,65150,"Milpitas city, California",2691,79517,47766,50686,2970,612,-279,0.2943722943722944,-0.09393939393939393,0.031910974673829626,0.03384181998817863,0.058596062028962635,0.0019308453143490056,-0.024754242040784004
0647794,"Mineral CDP, California",0,92,"Mineral CDP, California",0,359,47794,419,0,0,0,NA,NA,0,0,0,0,0
0647822,"Minkler CDP, California",12,1040,"Minkler CDP, California",0,958,47822,1084,0,-12,0,-1,NA,0.011538461538461539,0,0,-0.011538461538461539,0
0647976,"Mira Loma CDP, California",393,20145,NA,NA,NA,47976,15889,201,NA,NA,NA,NA,0.019508562918838422,NA,0.012650261186984707,NA,NA
0648046,"Mira Monte CDP, California",158,7793,"Mira Monte CDP, California",2,6633,48046,7880,56,-156,-54,-0.9873417721518988,-0.9642857142857143,0.02027460541511613,3.0152268958239106e-4,0.007106598984771574,-0.01997308272553374,-0.006805076295189182
0648060,"Miranda CDP, California",0,337,"Miranda CDP, California",77,605,48060,429,0,77,77,NA,NA,0,0.12727272727272726,0,0.12727272727272726,0.12727272727272726
0648147,"Mission Canyon CDP, California",0,2132,"Mission Canyon CDP, California",9,2508,48147,2529,12,9,-3,NA,-0.25,0,0.0035885167464114833,0.004744958481613286,0.0035885167464114833,-0.0011564417352018029
0648186,"Mission Hills CDP, California",47,3456,"Mission Hills CDP, California",170,3842,48186,3112,193,123,-23,2.617021276595745,-0.11917098445595854,0.013599537037037037,0.04424778761061947,0.06201799485861183,0.030648250573582433,-0.01777020724799236
0648256,"Mission Viejo city, California",1230,92615,"Mission Viejo city, California",1121,95516,48256,79411,760,-109,361,-0.0886178861788618,0.475,0.013280786049775953,0.0117362536119603,0.009570462530379922,-0.001544532437815653,0.002165791081580378
0648298,"Mi-Wuk Village CDP, California",0,847,"Mi-Wuk Village CDP, California",0,880,48298,1006,7,0,-7,NA,-1,0,0,0.006958250497017893,0,-0.006958250497017893
0648354,"Modesto city, California",7757,201898,"Modesto city, California",9511,212616,48354,166130,4421,1754,5090,0.22611834472089726,1.1513232300384528,0.03842039049420995,0.04473322797907966,0.02661168964064287,0.006312837484869709,0.01812153833843679
0648448,"Mohawk Vista CDP, California",0,167,"Mohawk Vista CDP, California",0,54,48448,169,2,0,-2,NA,-1,0,0,0.011834319526627219,0,-0.011834319526627219
0648452,"Mojave CDP, California",378,3634,"Mojave CDP, California",892,3855,48452,4276,95,514,797,1.3597883597883598,8.389473684210527,0.10401761144744083,0.23138780804150455,0.022217025257249765,0.12737019659406373,0.20917078278425477
0648480,"Mokelumne Hill CDP, California",0,736,"Mokelumne Hill CDP, California",0,691,48480,679,1,0,-1,NA,-1,0,0,0.0014727540500736377,0,-0.0014727540500736377
0648592,"Monmouth CDP, California",11,103,"Monmouth CDP, California",8,111,48592,180,13,-3,-5,-0.2727272727272727,-0.38461538461538464,0.10679611650485436,0.07207207207207207,0.07222222222222222,-0.03472404443278229,-1.50150150150144e-4
0648602,"Mono City CDP, California",0,78,"Mono City CDP, California",0,96,48602,79,0,0,0,NA,NA,0,0,0,0,0
0648641,"Mono Vista CDP, California",36,3051,"Mono Vista CDP, California",21,3446,48641,2741,10,-15,11,-0.4166666666666667,1.1,0.011799410029498525,0.006094022054556007,0.0036483035388544327,-0.005705387974942518,0.002445718515701574
0648648,"Monrovia city, California",2823,36616,"Monrovia city, California",2003,36816,48648,35673,3626,-820,-1623,-0.29047113000354235,-0.44760066188637615,0.07709744374044133,0.05440569317687962,0.10164550220054383,-0.022691750563561715,-0.04723980902366421
0648676,"Monson CDP, California",0,111,"Monson CDP, California",21,283,48676,153,0,21,21,NA,NA,0,0.07420494699646643,0,0.07420494699646643,0.07420494699646643
0648690,"Montague city, California",2,1401,"Montague city, California",0,1469,48690,1416,2,-2,-2,-1,-1,0.0014275517487508922,0,0.0014124293785310734,-0.0014275517487508922,-0.0014124293785310734
0648718,"Montalvin Manor CDP, California",88,2486,"Montalvin Manor CDP, California",292,2852,48718,2294,484,204,-192,2.3181818181818183,-0.39669421487603307,0.035398230088495575,0.10238429172510519,0.2109851787271142,0.06698606163660961,-0.10860088700200901
0648760,"Montara CDP, California",64,3085,"Montara CDP, California",0,2504,48760,2549,13,-64,-13,-1,-1,0.020745542949756886,0,0.0051000392310710085,-0.020745542949756886,-0.0051000392310710085
0648788,"Montclair city, California",1622,36704,"Montclair city, California",1249,39155,48788,29361,2726,-373,-1477,-0.22996300863131935,-0.5418195157740279,0.04419136878814298,0.03189886349125271,0.09284424917407445,-0.012292505296890271,-0.06094538568282174
0648816,"Montebello city, California",786,62416,"Montebello city, California",842,62742,48816,59562,579,56,263,0.07124681933842239,0.4542314335060449,0.012592924891053577,0.013420037614357208,0.009720963030119874,8.271127233036319e-4,0.003699074584237334
0648844,"Montecito CDP, California",37,9241,"Montecito CDP, California",59,8245,48844,9608,34,22,25,0.5945945945945946,0.7352941176470589,0.004003895682285467,0.007155852031534263,0.0035387177352206494,0.0031519563492487957,0.0036171342963136136
0648872,"Monterey city, California",631,27827,"Monterey city, California",1143,28352,48872,31968,937,512,206,0.8114104595879557,0.2198505869797225,0.02267581844970712,0.04031461625282167,0.02931056056056056,0.017638797803114552,0.011004055692261112
0648914,"Monterey Park city, California",84,60176,"Monterey Park city, California",415,60439,48914,60738,389,331,26,3.9404761904761907,0.06683804627249357,0.0013959053443233184,0.006866427306871391,0.006404557278804043,0.005470521962548072,4.6187002806734757e-4
0648916,"Monterey Park Tract CDP, California",0,279,"Monterey Park Tract CDP, California",0,272,48916,63,39,0,-39,NA,-1,0,0,0.6190476190476191,0,-0.6190476190476191
0648928,"Monte Rio CDP, California",0,1030,"Monte Rio CDP, California",0,977,48928,1130,8,0,-8,NA,-1,0,0,0.007079646017699115,0,-0.007079646017699115
0648956,"Monte Sereno city, California",32,3312,"Monte Sereno city, California",64,3479,48956,3287,9,32,55,1,6.111111111111111,0.00966183574879227,0.018396090830698476,0.0027380590203833284,0.008734255081906206,0.015658031810315148
0648998,"Montgomery Creek CDP, California",0,75,"Montgomery Creek CDP, California",0,145,48998,83,0,0,0,NA,NA,0,0,0,0,0
0649045,"Monument Hills CDP, California",6,1850,"Monument Hills CDP, California",0,1466,49045,607,11,-6,-11,-1,-1,0.003243243243243243,0,0.018121911037891267,-0.003243243243243243,-0.018121911037891267
0649138,"Moorpark city, California",391,33808,"Moorpark city, California",577,36372,49138,25494,396,186,181,0.47570332480818417,0.45707070707070707,0.011565309985802177,0.015863851314197736,0.015533066603906801,0.0042985413283955585,3.3078471029093434e-4
0649180,"Morada CDP, California",78,4880,"Morada CDP, California",31,3166,49180,3570,14,-47,17,-0.6025641025641025,1.2142857142857142,0.015983606557377048,0.009791535060012634,0.00392156862745098,-0.006192071497364414,0.005869966432561654
0649187,"Moraga town, California",297,15975,"Moraga town, California",121,17539,49187,15852,110,-176,11,-0.5925925925925926,0.1,0.018591549295774647,0.006898910998346542,0.00693918748422912,-0.011692638297428105,-4.0276485882577776e-5
0649270,"Moreno Valley city, California",33632,187428,"Moreno Valley city, California",36279,207289,49270,118833,16402,2647,19877,0.07870480494766889,1.2118644067796611,0.17943957146210812,0.17501652282562027,0.13802563261047016,-0.004423048636487847,0.03699089021515012
0649278,"Morgan Hill city, California",733,36630,"Morgan Hill city, California",830,44686,49278,24715,409,97,421,0.13233287858117326,1.0293398533007334,0.02001092001092001,0.018574050038043233,0.016548654663160023,-0.001436869972876776,0.0020253953748832106
0649348,"Morongo Valley CDP, California",0,3479,"Morongo Valley CDP, California",11,3090,49348,2721,6,11,5,NA,0.8333333333333334,0,0.0035598705501618125,0.002205071664829107,0.0035598705501618125,0.0013547988853327055
0649362,"Morro Bay city, California",0,10255,"Morro Bay city, California",135,10578,49362,9664,54,135,81,NA,1.5,0,0.012762336925694838,0.005587748344370861,0.012762336925694838,0.007174588581323977
0649432,"Moskowite Corner CDP, California",0,131,"Moskowite Corner CDP, California",0,121,49432,40,0,0,0,NA,NA,0,0,0,0,0
0649446,"Moss Beach CDP, California",16,2291,"Moss Beach CDP, California",17,3604,49446,2933,33,1,-16,0.0625,-0.48484848484848486,0.006983849847228284,0.0047169811320754715,0.01125127855438118,-0.002266868715152813,-0.006534297422305708
0649488,"Moss Landing CDP, California",0,209,"Moss Landing CDP, California",0,54,49488,208,10,0,-10,NA,-1,0,0,0.04807692307692308,0,-0.04807692307692308
0649544,"Mountain Center CDP, California",0,165,"Mountain Center CDP, California",0,0,49544,182,1,0,-1,NA,-1,0,NA,0.005494505494505495,NA,NA
0649558,"Mountain Gate CDP, California",0,1307,"Mountain Gate CDP, California",0,952,49558,1033,0,0,0,NA,NA,0,0,0,0,0
0649582,"Mountain House CDP, California",940,7496,"Mountain House CDP, California",1767,17966,49582,21,0,827,1767,0.8797872340425532,NA,0.12540021344717184,0.09835244350439719,0,-0.02704776994277465,0.09835244350439719
0649600,"Mountain Mesa CDP, California",38,1059,"Mountain Mesa CDP, California",5,1396,49600,679,0,-33,5,-0.868421052631579,NA,0.03588290840415486,0.0035816618911174787,0,-0.03230124651303738,0.0035816618911174787
0649628,"Mountain Ranch CDP, California",90,1462,"Mountain Ranch CDP, California",0,1141,49628,1046,2,-90,-2,-1,-1,0.06155950752393981,0,0.0019120458891013384,-0.06155950752393981,-0.0019120458891013384
0649651,"Mountain View CDP, California",33,2099,"Mountain View CDP, California",95,1970,49651,2364,27,62,68,1.878787878787879,2.5185185185185186,0.01572177227251072,0.048223350253807105,0.011421319796954314,0.03250157798129638,0.03680203045685279
0649670,"Mountain View city, California",1743,72510,"Mountain View city, California",1273,81656,49670,67346,3390,-470,-2117,-0.26965002868617327,-0.6244837758112094,0.024038063715349608,0.01558979131968257,0.05033706530454667,-0.008448272395667037,-0.0347472739848641
0649684,"Mountain View Acres CDP, California",336,3605,"Mountain View Acres CDP, California",357,4447,49684,2462,200,21,157,0.0625,0.785,0.09320388349514563,0.08027883966719136,0.08123476848090982,-0.012925043827954272,-9.559288137184624e-4
0649768,"Mount Hebron CDP, California",0,84,"Mount Hebron CDP, California",0,72,49768,124,0,0,0,NA,NA,0,0,0,0,0
0649796,"Mount Hermon CDP, California",0,860,"Mount Hermon CDP, California",0,1259,49796,945,3,0,-3,NA,-1,0,0,0.0031746031746031746,0,-0.0031746031746031746
0649810,"Mount Laguna CDP, California",0,66,"Mount Laguna CDP, California",0,117,49810,46,0,0,0,NA,NA,0,0,0,0,0
0649852,"Mount Shasta city, California",7,3416,"Mount Shasta city, California",50,3275,49852,3466,64,43,-14,6.142857142857143,-0.21875,0.0020491803278688526,0.015267175572519083,0.018465089440276975,0.01321799524465023,-0.0031979138677578917
0649950,"Muir Beach CDP, California",0,289,"Muir Beach CDP, California",0,336,49950,325,3,0,-3,NA,-1,0,0,0.009230769230769232,0,-0.009230769230769232
0650034,"Murphys CDP, California",0,2325,"Murphys CDP, California",0,2188,50034,1716,2,0,-2,NA,-1,0,0,0.0011655011655011655,0,-0.0011655011655011655
0650076,"Murrieta city, California",5093,95668,"Murrieta city, California",6669,112941,50076,22849,249,1576,6420,0.3094443353622619,25.783132530120483,0.05323619183007902,0.05904852976332776,0.010897632281500284,0.005812337933248736,0.04815089748182747
0650132,"Muscoy CDP, California",227,11294,"Muscoy CDP, California",320,12562,50132,7297,663,93,-343,0.40969162995594716,-0.5173453996983409,0.020099167699663537,0.025473650692564877,0.09085925722899822,0.005374482992901341,-0.06538560653643334
0650146,"Myers Flat CDP, California",0,91,"Myers Flat CDP, California",0,132,50146,82,0,0,0,NA,NA,0,0,0,0,0
0650188,"Myrtletown CDP, California",42,4750,"Myrtletown CDP, California",51,5222,50188,4413,49,9,2,0.21428571428571427,0.04081632653061224,0.008842105263157894,0.009766373037150517,0.011103557670518922,9.242677739926229e-4,-0.0013371846333684045
0650258,"Napa city, California",763,76006,"Napa city, California",533,79074,50258,63199,246,-230,287,-0.30144167758846657,1.1666666666666667,0.010038681156750783,0.006740521536788325,0.0038924666529533696,-0.0032981596199624583,0.0028480548838349553
0650398,"National City city, California",2511,57343,"National City city, California",2946,61121,50398,54253,4588,435,-1642,0.17323775388291518,-0.35789014821272885,0.043789128577158505,0.04819947317615877,0.08456675206901001,0.004410344599000263,-0.03636727889285125
0650734,"Needles city, California",180,4938,"Needles city, California",155,4965,50734,5222,64,-25,91,-0.1388888888888889,1.421875,0.03645200486026731,0.03121852970795569,0.012255840674071237,-0.005233475152311623,0.018962689033884452
0650874,"Nevada City city, California",16,3087,"Nevada City city, California",48,3144,50874,2929,6,32,42,2,7,0.0051830255911888565,0.015267175572519083,0.0020484807101399795,0.010084149981330226,0.013218694862379103
0650916,"Newark city, California",1822,41981,"Newark city, California",1844,47171,50916,37861,1635,22,209,0.012074643249176729,0.12782874617737003,0.043400585979371624,0.03909181488626487,0.043184279337576924,-0.004308771093106754,-0.004092464451312054
0651000,"Newcastle CDP, California",0,1116,"Newcastle CDP, California",4,1208,51000,1111,7,4,-3,NA,-0.42857142857142855,0,0.0033112582781456954,0.0063006300630063005,0.0033112582781456954,-0.002989371784860605
0651028,"New Cuyama CDP, California",6,413,"New Cuyama CDP, California",6,660,51028,495,6,0,0,0,0,0.014527845036319613,0.00909090909090909,0.012121212121212121,-0.005436935945410523,-0.0030303030303030307
0651042,"Newell CDP, California",0,584,"Newell CDP, California",0,566,51042,397,0,0,0,NA,NA,0,0,0,0,0
0651140,"Newman city, California",144,9806,"Newman city, California",229,11317,51140,4238,19,85,210,0.5902777777777778,11.052631578947368,0.014684886803997552,0.02023504462313334,0.004483246814535158,0.005550157819135789,0.015751797808598183
0651168,"New Pine Creek CDP, California",0,113,"New Pine Creek CDP, California",0,88,51168,78,2,0,-2,NA,-1,0,0,0.02564102564102564,0,-0.02564102564102564
0651182,"Newport Beach city, California",524,83571,"Newport Beach city, California",842,85694,51182,69611,239,318,603,0.6068702290076335,2.5230125523012554,0.006270117624534827,0.009825658739234952,0.0034333654163853414,0.003555541114700125,0.00639229332284961
0651280,"Nicasio CDP, California",0,7,"Nicasio CDP, California",0,71,51280,55,2,0,-2,NA,-1,0,0,0.03636363636363636,0,-0.03636363636363636
0651294,"Nice CDP, California",14,2267,"Nice CDP, California",101,2527,51294,2056,70,87,31,6.214285714285714,0.44285714285714284,0.0061755624172915745,0.039968341907400076,0.03404669260700389,0.033792779490108504,0.005921649300396188
0651336,"Nicolaus CDP, California",5,171,"Nicolaus CDP, California",0,148,51336,131,0,-5,0,-1,NA,0.029239766081871343,0,0,-0.029239766081871343,0
0651392,"Niland CDP, California",12,1306,"Niland CDP, California",36,631,51392,1183,16,24,20,2,1.25,0.009188361408882083,0.05705229793977813,0.013524936601859678,0.047863936530896045,0.04352736133791846
0651470,"Nipinnawasee CDP, California",0,793,"Nipinnawasee CDP, California",0,349,51470,303,0,0,0,NA,NA,0,0,0,0,0
0651476,"Nipomo CDP, California",171,16179,"Nipomo CDP, California",334,17601,51476,9651,79,163,255,0.9532163742690059,3.2278481012658227,0.010569256443537919,0.018976194534401455,0.008185680240389596,0.008406938090863536,0.01079051429401186
0651560,"Norco city, California",1813,26984,"Norco city, California",1262,26670,51560,23240,1852,-551,-590,-0.3039161610590182,-0.3185745140388769,0.06718796323747406,0.047319085114360705,0.07969018932874354,-0.019868878123113352,-0.032371104214382836
0651574,"Nord CDP, California",0,317,"Nord CDP, California",0,312,51574,276,6,0,-6,NA,-1,0,0,0.021739130434782608,0,-0.021739130434782608
0651622,"Norris Canyon CDP, California",0,812,"Norris Canyon CDP, California",0,897,51622,35,0,0,0,NA,NA,0,0,0,0,0
0651637,"North Auburn CDP, California",121,12561,"North Auburn CDP, California",66,14269,51637,10225,59,-55,7,-0.45454545454545453,0.11864406779661017,0.009632991003900963,0.004625411731726119,0.005770171149144254,-0.005007579272174844,-0.0011447594174181352
0651812,"North Edwards CDP, California",111,1104,"North Edwards CDP, California",50,880,51812,1502,76,-61,-26,-0.5495495495495496,-0.34210526315789475,0.10054347826086957,0.056818181818181816,0.05059920106524634,-0.04372529644268775,0.006218980752935477
0651820,"North El Monte CDP, California",10,4093,"North El Monte CDP, California",42,3933,51820,3397,20,32,22,3.2,1.1,0.002443195699975568,0.010678871090770405,0.0058875478363261706,0.008235675390794837,0.004791323254444234
0651840,"North Fair Oaks CDP, California",267,14270,"North Fair Oaks CDP, California",174,14372,51840,13912,447,-93,-273,-0.34831460674157305,-0.610738255033557,0.018710581639803783,0.012106874478151963,0.03213053479010926,-0.006603707161651821,-0.020023660311957295
0651890,"North Gate CDP, California",0,516,"North Gate CDP, California",0,685,51890,410,3,0,-3,NA,-1,0,0,0.007317073170731708,0,-0.007317073170731708
0651924,"North Highlands CDP, California",5308,42683,"North Highlands CDP, California",6168,47661,51924,41547,4102,860,2066,0.16201959306706856,0.5036567528035105,0.12435864395661037,0.129413986278089,0.09873155703179531,0.00505534232147864,0.03068242924629369
0651990,"North Lakeport CDP, California",32,3541,"North Lakeport CDP, California",0,3351,51990,2569,8,-32,-8,-1,-1,0.009036995199096301,0,0.003114052160373686,-0.009036995199096301,-0.003114052160373686
0652162,"North Richmond CDP, California",1197,2999,"North Richmond CDP, California",876,4085,52162,2378,1709,-321,-833,-0.2681704260651629,-0.4874195435927443,0.39913304434811603,0.21444308445532437,0.7186711522287637,-0.18468995989279166,-0.5042280677734393
0652246,"North San Juan CDP, California",0,131,"North San Juan CDP, California",0,178,52246,462,2,0,-2,NA,-1,0,0,0.004329004329004329,0,-0.004329004329004329
0652302,"North Shore CDP, California",39,1918,"North Shore CDP, California",0,2756,52302,566,3,-39,-3,-1,-1,0.020333680917622523,0,0.00530035335689046,-0.020333680917622523,-0.00530035335689046
0652379,"North Tustin CDP, California",75,24520,"North Tustin CDP, California",173,24705,52379,24358,128,98,45,1.3066666666666666,0.3515625,0.0030587275693311584,0.007002631046346893,0.005254947039986863,0.0039439034770157345,0.00174768400636003
0652526,"Norwalk city, California",5085,105108,"Norwalk city, California",4994,105304,52526,94275,3061,-91,1933,-0.01789577187807276,0.6314929761515844,0.048378810366480195,0.04742459925548887,0.03246884115619199,-9.542111109913237e-4,0.014955758099296883
0652582,"Novato city, California",1876,50488,"Novato city, California",2068,55642,52582,47602,1329,192,739,0.1023454157782516,0.5560571858540256,0.037157344319442245,0.03716616944035082,0.027918995000210074,8.8251209085718485e-06,0.009247174440140744
0652610,"Nubieber CDP, California",0,28,"Nubieber CDP, California",0,35,52610,70,0,0,0,NA,NA,0,0,0,0,0
0652624,"Nuevo CDP, California",69,5502,"Nuevo CDP, California",177,7182,52624,3431,45,108,132,1.565217391304348,2.933333333333333,0.012540894220283533,0.024644945697577275,0.013115709705625183,0.012104051477293742,0.011529235991952092
0652694,"Oakdale city, California",62,20076,"Oakdale city, California",68,22936,52694,12092,29,6,39,0.0967741935483871,1.3448275862068966,0.003088264594540745,0.002964771538193233,0.0023982798544492224,-1.2349305634751185e-4,5.664916837440108e-4
0652715,"Oak Glen CDP, California",0,509,"Oak Glen CDP, California",9,430,52715,497,49,9,-40,NA,-0.8163265306122449,0,0.020930232558139535,0.09859154929577464,0.020930232558139535,-0.0776613167376351
0652760,"Oak Hills CDP, California",53,8054,"Oak Hills CDP, California",413,10444,52760,2893,42,360,371,6.7924528301886795,8.833333333333334,0.006580581077725354,0.039544235924932974,0.014517801590044937,0.03296365484720762,0.025026434334888038
0652764,"Oakhurst CDP, California",83,3263,"Oakhurst CDP, California",0,3446,52764,2602,11,-83,-11,-1,-1,0.025436714679742567,0,0.004227517294388932,-0.025436714679742567,-0.004227517294388932
0653000,"Oakland city, California",109815,386909,"Oakland city, California",100966,425097,53000,372203,163300,-8849,-62334,-0.08058097709784638,-0.3817146356399265,0.28382642947049563,0.23751285000835104,0.4387390751820915,-0.046313579462144594,-0.20122622517374045
0653070,"Oakley city, California",1696,33496,"Oakley city, California",4043,41324,53070,16989,279,2347,3764,1.3838443396226414,13.491039426523297,0.05063291139240506,0.09783660826638273,0.01642239095885573,0.047203696873977664,0.081414217307527
0653116,"Oak Park CDP, California",89,14044,"Oak Park CDP, California",191,13853,53116,8650,110,102,81,1.146067415730337,0.7363636363636363,0.006337225861577898,0.013787627228759114,0.012716763005780347,0.007450401367181217,0.0010708642229787669
0653160,"Oak Shores CDP, California",0,217,"Oak Shores CDP, California",0,348,53160,204,0,0,0,NA,NA,0,0,0,0,0
0653182,"Oak View CDP, California",11,3962,"Oak View CDP, California",0,4598,53182,3755,19,-11,-19,-1,-1,0.0027763755678950025,0,0.005059920106524634,-0.0027763755678950025,-0.005059920106524634
0653196,"Oakville CDP, California",29,123,"Oakville CDP, California",0,91,53196,61,0,-29,0,-1,NA,0.23577235772357724,0,0,-0.23577235772357724,0
0653224,"Oasis CDP, California",31,5403,"Oasis CDP, California",2,2857,53224,2427,0,-29,2,-0.9354838709677419,NA,0.005737553211178975,7.000350017500875e-4,0,-0.005037518209428887,7.000350017500875e-4
0653266,"Occidental CDP, California",18,1221,"Occidental CDP, California",12,823,53266,1279,6,-6,6,-0.3333333333333333,1,0.014742014742014743,0.014580801944106925,0.004691164972634871,-1.6121279790781706e-4,0.009889636971472054
0653294,"Oceano CDP, California",0,7883,"Oceano CDP, California",77,7487,53294,6349,55,77,22,NA,0.4,0,0.010284493121410445,0.008662781540400063,0.010284493121410445,0.0016217115810103818
0653322,"Oceanside city, California",7453,164709,"Oceanside city, California",7933,175622,53322,128247,10134,480,-2201,0.06440359586743594,-0.21718965857509373,0.045249500634452273,0.04517087836375853,0.07901939226648577,-7.862227069374561e-5,-0.033848513902727244
0653378,"Ocotillo CDP, California",0,228,"Ocotillo CDP, California",0,89,53378,344,0,0,0,NA,NA,0,0,0,0,0
0653448,"Oildale CDP, California",234,32754,"Oildale CDP, California",713,34763,53448,26577,39,479,674,2.047008547008547,17.28205128205128,0.007144165598094889,0.020510312688778298,0.0014674342476577492,0.013366147090683409,0.01904287844112055
0653476,"Ojai city, California",0,7525,"Ojai city, California",53,7534,53476,7613,20,53,33,NA,1.65,0,0.007034775683567826,0.002627085248916327,0.007034775683567826,0.0044076904346514985
0653490,"Olancha CDP, California",0,203,"Olancha CDP, California",13,229,53490,56,0,13,13,NA,NA,0,0.056768558951965066,0,0.056768558951965066,0.056768558951965066
0653505,"Old Fig Garden CDP, California",0,5120,"Old Fig Garden CDP, California",107,5850,53505,5259,68,107,39,NA,0.5735294117647058,0,0.01829059829059829,0.0129302148697471,0.01829059829059829,0.0053603834208511905
0653602,"Old Station CDP, California",0,58,"Old Station CDP, California",0,31,53602,157,0,0,0,NA,NA,0,0,0,0,0
0653714,"Olivehurst CDP, California",136,13298,"Olivehurst CDP, California",251,13464,53714,10528,273,115,-22,0.8455882352941176,-0.08058608058608059,0.01022710181982253,0.01864230540701129,0.025930851063829786,0.00841520358718876,-0.007288545656818496
0653896,"Ontario city, California",13084,165215,"Ontario city, California",9665,176760,53896,134950,9728,-3419,-63,-0.26131152552736164,-0.006476151315789474,0.07919377780467875,0.05467866033039149,0.07208595776213413,-0.024515117474287258,-0.017407297431742637
0653910,"Onyx CDP, California",0,129,"Onyx CDP, California",0,478,53910,580,0,0,0,NA,NA,0,0,0,0,0
0653924,"Pleasure Point CDP, California",54,4949,"Pleasure Point CDP, California",112,6076,53924,6114,70,58,42,1.0740740740740742,0.6,0.010911295211153768,0.018433179723502304,0.01144913313706248,0.007521884512348536,0.0069840465864398245
0653980,"Orange city, California",2016,134569,"Orange city, California",2404,139887,53980,112382,1572,388,832,0.19246031746031747,0.5292620865139949,0.01498116208041971,0.017185299563218882,0.013988005196561727,0.0022041374827991723,0.003197294366657156
0654008,"Orange Cove city, California",85,8718,"Orange Cove city, California",117,10274,54008,5619,1,32,116,0.3764705882352941,116,0.0097499426473961915,0.01138796963208098,1.779676098949991e-4,0.0016380269846847893,0.011210002022185982
0654092,"Orangevale CDP, California",753,34202,"Orangevale CDP, California",654,34824,54092,34154,354,-99,300,-0.13147410358565736,0.847457627118644,0.022016256359277234,0.018780151619572708,0.0103648181764947,-0.003236104739704527,0.008415333443078007
0654120,"Orcutt CDP, California",390,28696,"Orcutt CDP, California",401,31118,54120,26236,291,11,110,0.028205128205128206,0.37800687285223367,0.013590744354613883,0.01288643228999293,0.01109162982161915,-7.04312064620953e-4,0.0017948024683737806
0654218,"Orick CDP, California",0,315,"Orick CDP, California",0,389,54218,422,0,0,0,NA,NA,0,0,0,0,0
0654232,"Orinda city, California",169,17485,"Orinda city, California",229,19646,54232,16642,138,60,91,0.35502958579881655,0.6594202898550725,0.009665427509293681,0.01165631680749262,0.008292272563393823,0.0019908892981989387,0.003364044244098797
0654274,"Orland city, California",32,7141,"Orland city, California",0,7622,54274,5270,12,-32,-12,-1,-1,0.004481165102926761,0,0.0022770398481973433,-0.004481165102926761,-0.0022770398481973433
0654372,"Orosi CDP, California",86,8745,"Orosi CDP, California",157,8300,54372,5509,12,71,145,0.8255813953488372,12.083333333333334,0.009834190966266438,0.01891566265060241,0.002178253766563805,0.00908147168433597,0.016737408884038605
0654386,"Oroville city, California",473,15369,"Oroville city, California",827,19393,54386,13059,393,354,434,0.7484143763213531,1.104325699745547,0.03077623788144967,0.04264425308100861,0.03009418791637951,0.011868015199558938,0.012550065164629101
0654388,"Oroville East CDP, California",29,8599,"Oroville East CDP, California",36,7771,54388,7518,125,7,-89,0.2413793103448276,-0.712,0.0033724851726944995,0.004632608415905289,0.016626762436818304,0.0012601232432107898,-0.011994154020913014
0654652,"Oxnard city, California",6892,192520,"Oxnard city, California",5422,208154,54652,142872,7473,-1470,-2051,-0.21329077190946025,-0.2744547035996253,0.035798878038645336,0.026048022137455922,0.05230556022173694,-0.009750855901189414,-0.02625753808428102
0654764,"Pacheco CDP, California",35,3241,"Pacheco CDP, California",133,4361,54764,3325,74,98,59,2.8,0.7972972972972973,0.01079913606911447,0.030497592295345103,0.022255639097744362,0.019698456226230635,0.008241953197600741
0654806,"Pacifica city, California",839,36805,"Pacifica city, California",962,38984,54806,37670,1964,123,-1002,0.1466030989272944,-0.5101832993890021,0.022795815785898656,0.02467679047814488,0.05213697902840456,0.0018809746922462227,-0.027460188550259685
0654848,"Pacific Grove city, California",182,14902,"Pacific Grove city, California",143,15522,54848,16117,223,-39,-80,-0.21428571428571427,-0.35874439461883406,0.012213125754932224,0.009212730318257957,0.013836321896134516,-0.0030003954366742674,-0.004623591577876559
0655044,"Pajaro CDP, California",8,2670,"Pajaro CDP, California",64,3620,55044,3275,11,56,53,7,4.818181818181818,0.00299625468164794,0.017679558011049725,0.0033587786259541984,0.014683303329401785,0.014320779385095527
0655048,"Pajaro Dunes CDP, California",0,300,"Pajaro Dunes CDP, California",0,284,55048,256,0,0,0,NA,NA,0,0,0,0,0
0655086,"Palermo CDP, California",25,4545,"Palermo CDP, California",75,5395,55086,4684,19,50,56,2,2.9473684210526314,0.005500550055005501,0.013901760889712697,0.0040563620836891546,0.008401210834707195,0.009845398806023541
0655156,"Palmdale city, California",20452,146184,"Palmdale city, California",20569,156293,55156,78199,4821,117,15748,0.005720711910815568,3.2665422111595106,0.1399058720516609,0.1316053821988189,0.06165040473663346,-0.008300489852842013,0.06995497746218543
0655184,"Palm Desert city, California",757,48534,"Palm Desert city, California",1573,52575,55184,32615,274,816,1299,1.0779392338177014,4.740875912408759,0.015597313223719454,0.02991916310033286,0.00840104246512341,0.014321849876613404,0.02151812063520945
0655254,"Palm Springs city, California",2050,45012,"Palm Springs city, California",2165,47897,55254,40323,1812,115,353,0.05609756097560976,0.19481236203090507,0.04554341064604994,0.04520116082426874,0.0449371326538204,-3.4224982178120145e-4,2.640281704483424e-4
0655282,"Palo Alto city, California",1875,62486,"Palo Alto city, California",1180,66573,55282,55872,1612,-695,-432,-0.37066666666666664,-0.2679900744416873,0.03000672150561726,0.017724903489402612,0.028851660939289807,-0.012281818016214648,-0.011126757449887194
0655296,"Palo Cedro CDP, California",19,1023,"Palo Cedro CDP, California",15,1143,55296,999,9,-4,6,-0.21052631578947367,0.6666666666666666,0.01857282502443793,0.013123359580052493,0.009009009009009009,-0.005449465444385435,0.004114350571043484
0655380,"Palos Verdes Estates city, California",152,13406,"Palos Verdes Estates city, California",51,13434,55380,13505,156,-101,-105,-0.6644736842105263,-0.6730769230769231,0.011338206773086678,0.003796337650736936,0.011551277304701962,-0.007541869122349742,-0.007754939653965026
0655422,"Palo Verde CDP, California",0,107,"Palo Verde CDP, California",0,65,55422,262,3,0,-3,NA,-1,0,0,0.011450381679389313,0,-0.011450381679389313
0655506,"Panorama Heights CDP, California",0,60,"Panorama Heights CDP, California",0,49,55506,50,0,0,0,NA,NA,0,0,0,0,0
0655520,"Paradise town, California",81,26425,"Paradise town, California",81,22135,55520,25465,36,0,45,0,1.25,0.003065279091769158,0.0036593629997741135,0.001413705085411349,5.940839080049555e-4,0.0022456579143627646
0655528,"Paradise CDP, California",0,283,"Paradise CDP, California",0,172,55528,78,0,0,0,NA,NA,0,0,0,0,0
0655604,"Paradise Park CDP, California",0,456,"Paradise Park CDP, California",0,550,55604,318,1,0,-1,NA,-1,0,0,0.0031446540880503146,0,-0.0031446540880503146
0655618,"Paramount city, California",6207,54187,"Paramount city, California",4937,54513,55618,47669,5098,-1270,-161,-0.2046077009827614,-0.03158101216163201,0.1145477697602746,0.0905655531708033,0.10694581384128049,-0.023982216589471306,-0.016380260670477195
0655728,"Parklawn CDP, California",0,792,"Parklawn CDP, California",0,1040,55728,1179,5,0,-5,NA,-1,0,0,0.004240882103477523,0,-0.004240882103477523
0655751,"Parksdale CDP, California",38,2977,"Parksdale CDP, California",82,2451,55751,1911,89,44,-7,1.1578947368421053,-0.07865168539325842,0.012764528048370843,0.03345573235414117,0.04657247514390372,0.020691204305770327,-0.013116742789762548
0655800,"Parkway CDP, California",2345,14153,"Parkway CDP, California",2687,15818,55800,13112,2414,342,273,0.14584221748400852,0.11309030654515327,0.1656892531618738,0.1698697686180301,0.18410616229408175,0.004180515456156303,-0.014236393676051645
0655842,"Parkwood CDP, California",136,2025,"Parkwood CDP, California",18,2183,55842,1659,71,-118,-53,-0.8676470588235294,-0.7464788732394366,0.0671604938271605,0.008245533669262483,0.04279686558167571,-0.05891496015789801,-0.034551331912413226
0655856,"Parlier city, California",60,13928,"Parlier city, California",54,15312,55856,7991,17,-6,37,-0.1,2.176470588235294,0.00430786904078116,0.0035266457680250786,0.0021273933174821673,-7.812232727560818e-4,0.0013992524505429113
0656000,"Pasadena city, California",14556,136449,"Pasadena city, California",12385,141258,56000,131597,24999,-2171,-12614,-0.14914811761472932,-0.5045801832073283,0.10667722006024229,0.08767645018335245,0.18996633661861592,-0.01900076987688984,-0.10228988643526347
0656028,"Pasatiempo CDP, California",0,1213,"Pasatiempo CDP, California",43,1206,56028,1021,1,43,42,NA,42,0,0.03565505804311774,9.794319294809011e-4,0.03565505804311774,0.034675626113636844
0656042,"Paskenta CDP, California",0,86,"Paskenta CDP, California",5,102,56042,97,0,5,5,NA,NA,0,0.049019607843137254,0,0.049019607843137254,0.049019607843137254
0656112,"Patterson city, California",1433,19110,"Patterson city, California",1418,22066,56112,8895,159,-15,1259,-0.0104675505931612,7.918238993710692,0.0749869178440607,0.06426176017402338,0.0178752107925801,-0.010725157670037316,0.04638654938144328
0656120,"Patterson Tract CDP, California",0,1610,"Patterson Tract CDP, California",0,2085,56120,1341,4,0,-4,NA,-1,0,0,0.002982848620432513,0,-0.002982848620432513
0656140,"Patton Village CDP, California",22,488,"Patton Village CDP, California",78,630,56140,824,131,56,-53,2.5454545454545454,-0.40458015267175573,0.045081967213114756,0.12380952380952381,0.15898058252427186,0.07872755659640907,-0.035171058714748044
0656182,"Paxton CDP, California",0,0,"Paxton CDP, California",0,0,56182,54,0,0,0,NA,NA,NA,NA,0,NA,NA
0656196,"Paynes Creek CDP, California",0,60,"Paynes Creek CDP, California",0,78,56196,46,0,0,0,NA,NA,0,0,0,0,0
0656294,"Pearsonville CDP, California",0,5,"Pearsonville CDP, California",0,7,56294,5,0,0,0,NA,NA,0,0,0,0,0
0656350,"Pedley CDP, California",547,11894,NA,NA,NA,56350,8869,378,NA,NA,NA,NA,0.04598957457541618,NA,0.042620363062352014,NA,NA
0656476,"Penngrove CDP, California",0,2986,"Penngrove CDP, California",0,2808,56476,2665,11,0,-11,NA,-1,0,0,0.004127579737335835,0,-0.004127579737335835
0656518,"Penn Valley CDP, California",0,1162,"Penn Valley CDP, California",0,1341,56518,1242,2,0,-2,NA,-1,0,0,0.001610305958132045,0,-0.001610305958132045
0656546,"Penryn CDP, California",0,751,"Penryn CDP, California",25,818,56546,642,1,25,24,NA,24,0,0.030562347188264057,0.001557632398753894,0.030562347188264057,0.029004714789510163
0656700,"Perris city, California",7368,63644,"Perris city, California",7751,77290,56700,21470,2794,383,4957,0.05198154180238871,1.7741589119541876,0.1157689648670731,0.1002846422564368,0.13013507219375872,-0.0154843226106363,-0.029850429937321926
0656756,"Pescadero CDP, California",0,772,"Pescadero CDP, California",0,219,56756,606,6,0,-6,NA,-1,0,0,0.009900990099009901,0,-0.009900990099009901
0656784,"Petaluma city, California",643,56689,"Petaluma city, California",718,60767,56784,44126,555,75,163,0.1166407465007776,0.2936936936936937,0.011342588509234596,0.011815623611499662,0.012577618637537959,4.7303510226506633e-4,-7.619950260382962e-4
0656798,"Peters CDP, California",0,724,"Peters CDP, California",54,623,56798,476,4,54,50,NA,12.5,0,0.08667736757624397,0.008403361344537815,0.08667736757624397,0.07827400623170616
0656826,"Phelan CDP, California",170,14016,"Phelan CDP, California",226,15987,56826,7301,79,56,147,0.32941176470588235,1.860759493670886,0.012128995433789954,0.014136485894789516,0.010820435556773044,0.002007490460999562,0.0033160503380164717
0656854,"Phillipsville CDP, California",0,77,"Phillipsville CDP, California",0,70,56854,139,0,0,0,NA,NA,0,0,0,0,0
0656868,"Philo CDP, California",0,244,"Philo CDP, California",0,175,56868,334,0,0,0,NA,NA,0,0,0,0,0
0656870,"Phoenix Lake CDP, California",8,3989,"Phoenix Lake CDP, California",39,4511,56870,3819,16,31,23,3.875,1.4375,0.002005515166708448,0.008645533141210375,0.004189578423671118,0.006640017974501927,0.004455954717539257
0656924,"Pico Rivera city, California",350,62988,"Pico Rivera city, California",635,63001,56924,59187,408,285,227,0.8142857142857143,0.5563725490196079,0.005556613958214263,0.010079205091982667,0.0068934056465102134,0.004522591133768404,0.0031857994454724536
0656938,"Piedmont city, California",131,10573,"Piedmont city, California",155,11317,56938,10591,147,24,8,0.183206106870229,0.05442176870748299,0.012390050127683723,0.013696209242732172,0.013879709187045605,0.0013061591150484494,-1.8349994431343317e-4
0657011,"Pierpoint CDP, California",0,12,"Pierpoint CDP, California",0,39,57011,77,0,0,0,NA,NA,0,0,0,0,0
0657036,"Pike CDP, California",21,157,"Pike CDP, California",0,159,57036,127,0,-21,0,-1,NA,0.1337579617834395,0,0,-0.1337579617834395,0
0657070,"Pine Canyon CDP, California",0,1998,"Pine Canyon CDP, California",1,2369,57070,1438,15,1,-14,NA,-0.9333333333333333,0,4.2211903756859433e-4,0.01043115438108484,4.2211903756859433e-4,-0.010009035343516246
0657134,"Pine Flat CDP, California",0,107,"Pine Flat CDP, California",0,146,57134,143,0,0,0,NA,NA,0,0,0,0,0
0657148,"Pine Grove CDP, California",0,2373,"Pine Grove CDP, California",0,1762,57148,1995,0,0,0,NA,NA,0,0,0,0,0
0657204,"Pine Hills CDP, California",0,2664,"Pine Hills CDP, California",3,3375,57204,2947,8,3,-5,NA,-0.625,0,8.888888888888889e-4,0.0027146250424160165,8.888888888888889e-4,-0.0018257361535271275
0657240,"Pine Mountain Club CDP, California",29,1460,"Pine Mountain Club CDP, California",0,1751,57240,1450,12,-29,-12,-1,-1,0.01986301369863014,0,0.008275862068965517,-0.01986301369863014,-0.008275862068965517
0657244,"Pine Mountain Lake CDP, California",0,2756,"Pine Mountain Lake CDP, California",0,2772,57244,2235,4,0,-4,NA,-1,0,0,0.0017897091722595079,0,-0.0017897091722595079
0657260,"Pine Valley CDP, California",0,972,"Pine Valley CDP, California",33,1477,57260,1297,0,33,33,NA,NA,0,0.02234258632362898,0,0.02234258632362898,0.02234258632362898
0657288,"Pinole city, California",1671,18461,"Pinole city, California",2269,19279,57288,17593,1236,598,1033,0.35786953919808495,0.8357605177993528,0.0905151400249174,0.11769282639141035,0.07025521514238618,0.027177686366492954,0.04743761124902417
0657302,"Pi?on Hills CDP, California",66,5391,"Piñon Hills CDP, California",0,7661,57302,3799,19,-66,-19,-1,-1,0.012242626599888704,0,0.005001316135825217,-0.012242626599888704,-0.005001316135825217
0657330,"Pioneer CDP, California",0,1087,"Pioneer CDP, California",6,1386,57330,853,0,6,6,NA,NA,0,0.004329004329004329,0,0.004329004329004329,0.004329004329004329
0657372,"Piru CDP, California",5,1478,"Piru CDP, California",41,1805,57372,1225,0,36,41,7.2,NA,0.0033829499323410014,0.022714681440443214,0,0.01933173150810221,0.022714681440443214
0657414,"Pismo Beach city, California",61,7802,"Pismo Beach city, California",229,8180,57414,7674,38,168,191,2.7540983606557377,5.026315789473684,0.007818508074852602,0.027995110024449876,0.0049517852488923635,0.020176601949597275,0.02304332477555751
0657456,"Pittsburg city, California",11100,61723,"Pittsburg city, California",11018,71422,57456,47804,8414,-82,2604,-0.007387387387387387,0.30948419301164726,0.17983571764172188,0.15426619248970905,0.17601037570077818,-0.02556952515201283,-0.021744183211069135
0657512,"Pixley CDP, California",166,2949,"Pixley CDP, California",142,3347,57512,2457,128,-24,14,-0.14457831325301204,0.109375,0.05629026788741946,0.04242605318195399,0.052096052096052094,-0.01386421470546547,-0.009669998914098102
0657526,"Placentia city, California",691,49566,"Placentia city, California",1029,51818,57526,41265,765,338,264,0.48914616497829233,0.34509803921568627,0.013941007948997296,0.019857964413910224,0.018538713195201745,0.005916956464912929,0.0013192512187084789
0657540,"Placerville city, California",83,10384,"Placerville city, California",99,10970,57540,8505,22,16,77,0.1927710843373494,3.5,0.007993066255778121,0.00902461257976299,0.002586713697824809,0.0010315463239848697,0.006437898881938181
0657568,"Plainview CDP, California",0,1027,"Plainview CDP, California",0,887,57568,965,0,0,0,NA,NA,0,0,0,0,0
0657582,"Planada CDP, California",30,4295,"Planada CDP, California",0,4418,57582,3531,9,-30,-9,-1,-1,0.006984866123399301,0,0.002548853016142736,-0.006984866123399301,-0.002548853016142736
0657764,"Pleasant Hill city, California",636,32826,"Pleasant Hill city, California",896,34840,57764,31879,450,260,446,0.4088050314465409,0.9911111111111112,0.019374885761286785,0.02571756601607348,0.014115875654819787,0.006342680254786695,0.011601690361253693
0657792,"Pleasanton city, California",1525,68204,"Pleasanton city, California",1510,81717,57792,51306,697,-15,813,-0.009836065573770493,1.1664275466284075,0.022359392411002287,0.018478407185775297,0.013585155732273028,-0.00388098522522699,0.004893251453502268
0657828,"Plumas Eureka CDP, California",0,234,"Plumas Eureka CDP, California",0,364,57828,238,0,0,0,NA,NA,0,0,0,0,0
0657829,"Plumas Lake CDP, California",345,5161,"Plumas Lake CDP, California",318,7573,57829,83,3,-27,315,-0.0782608695652174,105,0.0668475101724472,0.04199128482767728,0.03614457831325301,-0.024856225344769917,0.005846706514424267
0657834,"Plymouth city, California",0,903,"Plymouth city, California",5,980,57834,811,0,5,5,NA,NA,0,0.00510204081632653,0,0.00510204081632653,0.00510204081632653
0657876,"Point Arena city, California",0,476,"Point Arena city, California",10,421,57876,407,1,10,9,NA,9,0,0.023752969121140142,0.002457002457002457,0.023752969121140142,0.021295966664137685
0657960,"Point Reyes Station CDP, California",23,831,"Point Reyes Station CDP, California",0,288,57960,898,9,-23,-9,-1,-1,0.027677496991576414,0,0.01002227171492205,-0.027677496991576414,-0.01002227171492205
0658030,"Pollock Pines CDP, California",0,7339,"Pollock Pines CDP, California",52,7156,58030,6299,9,52,43,NA,4.777777777777778,0,0.0072666294019005035,0.0014287982219399905,0.0072666294019005035,0.005837831179960513
0658072,"Pomona city, California",12197,148775,"Pomona city, California",8599,152209,58072,131632,19000,-3598,-10401,-0.2949905714519964,-0.5474210526315789,0.08198286002352546,0.05649468822474361,0.14434180138568128,-0.025488171798781857,-0.08784711316093768
0658134,"Ponderosa CDP, California",0,60,"Ponderosa CDP, California",0,18,58134,25,0,0,0,NA,NA,0,0,0,0,0
0658191,"Poplar-Cotton Center CDP, California",0,2095,"Poplar-Cotton Center CDP, California",0,2259,58191,1953,2,0,-2,NA,-1,0,0,0.0010240655401945725,0,-0.0010240655401945725
0658226,"Port Costa CDP, California",0,168,"Port Costa CDP, California",0,180,58226,228,2,0,-2,NA,-1,0,0,0.008771929824561403,0,-0.008771929824561403
0658240,"Porterville city, California",519,52762,"Porterville city, California",374,59697,58240,35935,315,-145,59,-0.279383429672447,0.1873015873015873,0.009836624843637466,0.0062649714391007924,0.008765827187978295,-0.0035716534045366734,-0.0025008557488775023
0658296,"Port Hueneme city, California",914,21723,"Port Hueneme city, California",1242,22156,58296,20319,1127,328,115,0.3588621444201313,0.10204081632653061,0.04207521981310132,0.0560570500090269,0.055465328018111125,0.013981830195925582,5.917219909157764e-4
0658352,"Portola city, California",46,3042,"Portola city, California",5,1913,58352,2185,10,-41,-5,-0.8913043478260869,-0.5,0.015121630506245891,0.0026136957658128594,0.004576659038901602,-0.012507934740433033,-0.0019629632730887425
0658380,"Portola Valley town, California",0,4283,"Portola Valley town, California",17,4592,58380,4194,13,17,4,NA,0.3076923076923077,0,0.0037020905923344947,0.003099666189794945,0.0037020905923344947,6.024244025395497e-4
0658422,"Posey CDP, California",0,6,"Posey CDP, California",0,0,58422,6,0,0,0,NA,NA,0,NA,0,NA,NA
0658436,"Poso Park CDP, California",0,0,"Poso Park CDP, California",0,3,58436,33,0,0,0,NA,NA,NA,0,0,NA,0
0658478,"Potrero CDP, California",0,1174,"Potrero CDP, California",0,841,58478,512,1,0,-1,NA,-1,0,0,0.001953125,0,-0.001953125
0658506,"Potter Valley CDP, California",0,824,"Potter Valley CDP, California",0,498,58506,736,3,0,-3,NA,-1,0,0,0.004076086956521739,0,-0.004076086956521739
0658520,"Poway city, California",512,47481,"Poway city, California",786,49701,58520,43424,625,274,161,0.53515625,0.2576,0.010783260672690129,0.01581457113538963,0.014392962417096537,0.005031310462699501,0.001421608718293093
0658618,"Prattville CDP, California",0,21,"Prattville CDP, California",0,28,58618,37,0,0,0,NA,NA,0,0,0,0,0
0658758,"Princeton CDP, California",0,244,"Princeton CDP, California",0,382,58758,314,0,0,0,NA,NA,0,0,0,0,0
0658814,"Proberta CDP, California",0,207,"Proberta CDP, California",0,182,58814,267,0,0,0,NA,NA,0,0,0,0,0
0658870,"Prunedale CDP, California",316,19044,"Prunedale CDP, California",268,20327,58870,15879,260,-48,8,-0.1518987341772152,0.03076923076923077,0.016593152699012813,0.013184434495990554,0.016373827067195666,-0.0034087182030222585,-0.003189392571205112
0659052,"Quartz Hill CDP, California",932,10398,"Quartz Hill CDP, California",612,10003,59052,9611,364,-320,248,-0.34334763948497854,0.6813186813186813,0.08963262165801116,0.061181645506348095,0.037873270211216316,-0.02845097615166306,0.02330837529513178
0659080,"Quincy CDP, California",55,1529,"Quincy CDP, California",109,1952,59080,1837,41,54,68,0.9818181818181818,1.6585365853658536,0.03597122302158273,0.05584016393442623,0.02231899836690256,0.019868940912843497,0.03352116556752367
0659115,"Rackerby CDP, California",0,218,"Rackerby CDP, California",12,208,59115,184,0,12,12,NA,NA,0,0.057692307692307696,0,0.057692307692307696,0.057692307692307696
0659220,"Rail Road Flat CDP, California",70,292,"Rail Road Flat CDP, California",5,191,59220,793,3,-65,2,-0.9285714285714286,0.6666666666666666,0.23972602739726026,0.02617801047120419,0.0037831021437578815,-0.21354801692605607,0.022394908327446308
0659248,"Rainbow CDP, California",16,1902,"Rainbow CDP, California",30,2360,59248,1711,40,14,-10,0.875,-0.25,0.008412197686645636,0.012711864406779662,0.023378141437755698,0.004299666720134026,-0.010666277030976036
0659290,"Raisin City CDP, California",0,231,"Raisin City CDP, California",0,414,59290,308,0,0,0,NA,NA,0,0,0,0,0
0659346,"Ramona CDP, California",193,21482,"Ramona CDP, California",129,21323,59346,17324,109,-64,20,-0.3316062176165803,0.1834862385321101,0.008984265897030072,0.006049805374478263,0.006291849457400138,-0.002934460522551809,-2.4204408292187538e-4
0659426,"Rancho Calaveras CDP, California",10,6191,"Rancho Calaveras CDP, California",99,7026,59426,2672,38,89,61,8.9,1.605263157894737,0.0016152479405588758,0.014090520922288642,0.014221556886227544,0.012475272981729766,-1.310359639389025e-4
0659444,"Rancho Cordova city, California",5954,63297,"Rancho Cordova city, California",6684,73147,59444,54760,5881,730,803,0.12260665099093046,0.1365414045230403,0.09406448962826042,0.09137763681353986,0.10739590942293645,-0.0026868528147205584,-0.01601827260939659
0659451,"Rancho Cucamonga city, California",14312,160780,"Rancho Cucamonga city, California",17635,176379,59451,101432,5955,3323,11680,0.2321827836780324,1.961376994122586,0.08901604677198656,0.09998355813333787,0.05870928306648789,0.01096751136135131,0.041274275066849976
0659500,"Rancho Mirage city, California",348,16726,"Rancho Mirage city, California",438,18193,59500,9810,143,90,295,0.25862068965517243,2.062937062937063,0.020805930886045678,0.02407519375584016,0.014576962283384301,0.0032692628697944814,0.009498231472455858
0659506,"Rancho Murieta CDP, California",239,6191,"Rancho Murieta CDP, California",336,5744,59506,2651,38,97,298,0.40585774058577406,7.842105263157895,0.03860442577935713,0.0584958217270195,0.014334213504337986,0.019891395947662364,0.04416160822268151
0659514,"Rancho Palos Verdes city, California",999,41535,"Rancho Palos Verdes city, California",785,42030,59514,41685,788,-214,-3,-0.21421421421421422,-0.0038071065989847717,0.024052004333694473,0.01867713537949084,0.018903682379752908,-0.005374868954203634,-2.265470002620687e-4
0659550,"Rancho San Diego CDP, California",890,20247,"Rancho San Diego CDP, California",461,21799,59550,17880,454,-429,7,-0.4820224719101124,0.015418502202643172,0.043957129451276736,0.02114775907151704,0.025391498881431766,-0.022809370379759695,-0.004243739809914725
0659584,"Rancho Santa Fe CDP, California",0,2865,"Rancho Santa Fe CDP, California",0,2510,59584,2964,17,0,-17,NA,-1,0,0,0.005735492577597841,0,-0.005735492577597841
0659587,"Rancho Santa Margarita city, California",523,47539,"Rancho Santa Margarita city, California",1548,48503,59587,15419,208,1025,1340,1.9598470363288718,6.4423076923076925,0.011001493510591305,0.031915551615363996,0.01348985018483689,0.02091405810477269,0.018425701430527106
0659604,"Rancho Tehama Reserve CDP, California",0,1112,"Rancho Tehama Reserve CDP, California",9,1682,59604,988,10,9,-1,NA,-0.1,0,0.00535077288941736,0.010121457489878543,0.00535077288941736,-0.004770684600461182
0659668,"Randsburg CDP, California",0,42,"Randsburg CDP, California",0,125,59668,133,0,0,0,NA,NA,0,0,0,0,0
0659892,"Red Bluff city, California",81,13977,"Red Bluff city, California",293,14264,59892,12422,70,212,223,2.617283950617284,3.1857142857142855,0.005795235028976175,0.02054122265844083,0.0056351634197391726,0.014745987629464656,0.014906059238701658
0659896,"Red Corral CDP, California",2,1717,"Red Corral CDP, California",18,1787,59896,1150,40,16,-22,8,-0.55,0.0011648223645894002,0.010072747621712367,0.034782608695652174,0.008907925257122968,-0.024709861073939805
0659906,"Redcrest CDP, California",0,45,"Redcrest CDP, California",0,24,59906,77,0,0,0,NA,NA,0,0,0,0,0
0659920,"Redding city, California",779,89380,"Redding city, California",1378,91580,59920,67489,702,599,676,0.7689345314505777,0.9629629629629629,0.00871559633027523,0.015046953483293296,0.010401695091051875,0.006331357153018066,0.004645258392241421
0659962,"Redlands city, California",3486,68852,"Redlands city, California",3870,71198,59962,62934,2341,384,1529,0.11015490533562823,0.653139683895771,0.05063033753558357,0.0543554594230175,0.0371976991769155,0.00372512188743393,0.017157760246102
0660018,"Redondo Beach city, California",1973,66054,"Redondo Beach city, California",2328,67423,60018,60167,960,355,1368,0.17992904206791688,1.425,0.029869500711539043,0.03452827670082909,0.015955590273738097,0.00465877598929005,0.018572686427090996
0660088,"Redway CDP, California",0,1024,"Redway CDP, California",0,1358,60088,1212,4,0,-4,NA,-1,0,0,0.0033003300330033004,0,-0.0033003300330033004
0660102,"Redwood City city, California",2108,75193,"Redwood City city, California",1443,85784,60102,65964,2404,-665,-961,-0.31546489563567365,-0.3997504159733777,0.0280345244903116,0.01682131866082253,0.036444121035716454,-0.011213205829489068,-0.019622802374893923
0660214,"Redwood Valley CDP, California",0,1528,"Redwood Valley CDP, California",0,1713,60214,1606,5,0,-5,NA,-1,0,0,0.00311332503113325,0,-0.00311332503113325
0660242,"Reedley city, California",106,23669,"Reedley city, California",301,25591,60242,16316,61,195,240,1.8396226415094339,3.9344262295081966,0.004478431703916515,0.011761947559688953,0.003738661436626624,0.007283515855772438,0.008023286123062329
0660279,"Reliez Valley CDP, California",14,2902,"Reliez Valley CDP, California",110,3518,60279,2584,45,96,65,6.857142857142857,1.4444444444444444,0.004824259131633356,0.03126776577600909,0.01741486068111455,0.02644350664437574,0.013852905094894542
0660466,"Rialto city, California",15792,99311,"Rialto city, California",13386,103045,60466,72672,14749,-2406,-1363,-0.15235562310030396,-0.09241304495220015,0.15901561760530053,0.12990441069435685,0.2029529942756495,-0.029111206910943682,-0.07304858358129265
0660592,"Richfield CDP, California",0,268,"Richfield CDP, California",0,300,60592,160,0,0,0,NA,NA,0,0,0,0,0
0660606,"Richgrove CDP, California",0,2694,"Richgrove CDP, California",0,2316,60606,1899,2,0,-2,NA,-1,0,0,0.00105318588730911,0,-0.00105318588730911
0660620,"Richmond city, California",29030,102264,"Richmond city, California",22150,109884,60620,88169,38279,-6880,-16129,-0.23699621081639682,-0.42135374487316807,0.28387311272784166,0.20157620763714462,0.43415486168608014,-0.08229690509069704,-0.23257865404893552
0660662,"Richvale CDP, California",0,204,"Richvale CDP, California",0,209,60662,239,0,0,0,NA,NA,0,0,0,0,0
0660704,"Ridgecrest city, California",1523,27386,"Ridgecrest city, California",1233,28755,60704,27919,884,-290,349,-0.19041365725541695,0.3947963800904977,0.055612356678594904,0.042879499217527386,0.031663025179984955,-0.012732857461067518,0.011216474037542432
0660706,"Ridgemark CDP, California",69,4052,"Ridgemark CDP, California",15,2872,60706,1686,10,-54,5,-0.782608695652174,0.5,0.01702862783810464,0.005222841225626741,0.005931198102016607,-0.011805786612477897,-7.083568763898663e-4
0660900,"Rio Dell city, California",75,3329,"Rio Dell city, California",5,3373,60900,3025,7,-70,-2,-0.9333333333333333,-0.2857142857142857,0.022529288074496844,0.0014823599169878447,0.0023140495867768596,-0.021046928157509,-8.316896697890149e-4
0660928,"Rio del Mar CDP, California",121,9422,"Rio del Mar CDP, California",138,9657,60928,8919,34,17,104,0.14049586776859505,3.0588235294117645,0.012842284016132455,0.014290152221186705,0.0038120865567888777,0.0014478682050542493,0.010478065664397827
0660942,"Rio Linda CDP, California",618,14695,"Rio Linda CDP, California",397,16359,60942,12694,225,-221,172,-0.35760517799352753,0.7644444444444445,0.04205512078938414,0.024267987040772664,0.01772490940601859,-0.01778713374861148,0.0065430776347540735
0660970,"Rio Oso CDP, California",0,333,"Rio Oso CDP, California",0,350,60970,441,0,0,0,NA,NA,0,0,0,0,0
0660984,"Rio Vista city, California",405,6874,"Rio Vista city, California",678,8947,60984,3413,3,273,675,0.674074074074074,225,0.05891766075065464,0.07577959092433217,8.789920890711983e-4,0.016861930173677535,0.07490059883526097
0661012,"Ripley CDP, California",20,704,"Ripley CDP, California",79,444,61012,769,61,59,18,2.95,0.29508196721311475,0.028409090909090908,0.17792792792792791,0.07932379713914174,0.149518837018837,0.09860413078878617
0661026,"Ripon city, California",303,13792,"Ripon city, California",93,15777,61026,7751,25,-210,68,-0.693069306930693,2.72,0.02196925754060325,0.005894656778855296,0.003225390272222939,-0.01607460076174795,0.002669266506632357
0661068,"Riverbank city, California",736,21778,"Riverbank city, California",418,24482,61068,9152,27,-318,391,-0.4320652173913043,14.481481481481481,0.03379557351455598,0.01707376848296708,0.002950174825174825,-0.016721805031588897,0.014123593657792255
0661096,"Riverdale CDP, California",0,3193,"Riverdale CDP, California",10,3433,61096,1980,45,10,-35,NA,-0.7777777777777778,0,0.0029129041654529565,0.022727272727272728,0.0029129041654529565,-0.01981436856181977
0661106,"Riverdale Park CDP, California",0,1154,"Riverdale Park CDP, California",0,1033,61106,1032,3,0,-3,NA,-1,0,0,0.0029069767441860465,0,-0.0029069767441860465
0661124,"River Pines CDP, California",0,574,"River Pines CDP, California",21,566,61124,355,0,21,21,NA,NA,0,0.037102473498233215,0,0.037102473498233215,0.037102473498233215
0662000,"Riverside city, California",19519,300553,"Riverside city, California",20088,326414,62000,227585,16821,569,3267,0.029151083559608586,0.1942215088282504,0.06494362059270745,0.06154147800033087,0.07391084649691324,-0.0034021425923765752,-0.012369368496582364
0662168,"Robbins CDP, California",0,559,"Robbins CDP, California",0,421,62168,310,0,0,0,NA,NA,0,0,0,0,0
0662200,"Robinson Mill CDP, California",0,129,"Robinson Mill CDP, California",0,53,62200,51,0,0,0,NA,NA,0,0,0,0,0
0662364,"Rocklin city, California",912,54276,"Rocklin city, California",1202,64835,62364,18945,141,290,1061,0.31798245614035087,7.524822695035461,0.01680300685385806,0.018539369167887714,0.007442596991290578,0.0017363623140296547,0.011096772176597136
0662490,"Rodeo CDP, California",1236,9127,"Rodeo CDP, California",1504,10409,62490,8341,939,268,565,0.2168284789644013,0.6017039403620873,0.13542237317848144,0.14449034489384185,0.11257642968469009,0.009067971715360418,0.031913915209151766
0662496,"Rodriguez Camp CDP, California",0,173,"Rodriguez Camp CDP, California",0,101,62496,193,0,0,0,NA,NA,0,0,0,0,0
0662546,"Rohnert Park city, California",1003,40521,"Rohnert Park city, California",1089,42902,62546,36608,976,86,113,0.08574277168494517,0.11577868852459017,0.024752597418622443,0.025383432007831802,0.02666083916083916,6.308345892093586e-4,-0.001277407153007358
0662602,"Rolling Hills city, California",17,1808,"Rolling Hills city, California",22,1513,62602,1871,28,5,-6,0.29411764705882354,-0.21428571428571427,0.009402654867256638,0.014540647719762063,0.014965259219668627,0.005137992852505425,-4.2461149990656415e-4
0662625,"Rolling Hills CDP, California",7,915,"Rolling Hills CDP, California",20,718,62625,912,9,13,11,1.8571428571428572,1.2222222222222223,0.007650273224043716,0.027855153203342618,0.009868421052631578,0.0202048799792989,0.01798673215071104
0662644,"Rolling Hills Estates city, California",89,8004,"Rolling Hills Estates city, California",160,8169,62644,7789,61,71,99,0.797752808988764,1.6229508196721312,0.01111944027986007,0.019586240665932182,0.00783155732443189,0.008466800386072112,0.011754683341500292
0662700,"Rollingwood CDP, California",86,2935,"Rollingwood CDP, California",189,3449,62700,2377,272,103,-83,1.197674418604651,-0.30514705882352944,0.0293015332197615,0.05479849231661351,0.11442995372318047,0.025496959096852012,-0.059631461406566964
0662756,"Romoland CDP, California",241,1266,"Romoland CDP, California",0,2295,62756,765,23,-241,-23,-1,-1,0.19036334913112166,0,0.030065359477124184,-0.19036334913112166,-0.030065359477124184
0662826,"Rosamond CDP, California",1406,17029,"Rosamond CDP, California",1753,20851,62826,8776,288,347,1465,0.24679943100995733,5.086805555555555,0.08256503611486288,0.08407270634501943,0.032816773017319965,0.0015076702301565492,0.05125593332769946
0662854,"Rosedale CDP, California",181,14847,"Rosedale CDP, California",219,16820,62854,6153,46,38,173,0.20994475138121546,3.760869565217391,0.012191015019869333,0.013020214030915576,0.007476027953843654,8.29199011046243e-4,0.005544186077071922
0662860,"Rose Hills CDP, California",66,2924,"Rose Hills CDP, California",26,2771,62860,2911,76,-40,-50,-0.6060606060606061,-0.6578947368421053,0.022571819425444596,0.009382894261999277,0.02610786671246994,-0.013188925163445319,-0.016724972450470665
0662868,"Roseland CDP, California",157,6450,NA,NA,NA,62868,5093,232,NA,NA,NA,NA,0.024341085271317828,NA,0.04555271941881013,NA,NA
0662896,"Rosemead city, California",255,53670,"Rosemead city, California",264,54282,62896,51714,321,9,-57,0.03529411764705882,-0.17757009345794392,0.0047512576858580215,0.004863490659887256,0.006207216614456433,1.1223297402923431e-4,-0.0013437259545691776
0662910,"Rosemont CDP, California",2880,22851,"Rosemont CDP, California",2943,23602,62910,22851,1902,63,1041,0.021875,0.5473186119873817,0.1260338716029933,0.12469282264214897,0.0832348693711435,-0.001341048960844346,0.041457953271005474
0662938,"Roseville city, California",1856,113820,"Roseville city, California",2926,135637,62938,44745,407,1070,2519,0.5765086206896551,6.1891891891891895,0.0163064487787735,0.021572284848529532,0.009095988378589787,0.00526583606975603,0.012476296469939745
0662980,"Ross town, California",6,2002,"Ross town, California",69,2290,62980,2123,1,63,68,10.5,68,0.002997002997002997,0.030131004366812226,4.710315591144607e-4,0.02713400136980923,0.029659972807697766
0663050,"Rossmoor CDP, California",44,10492,"Rossmoor CDP, California",101,11128,63050,9951,45,57,56,1.2954545454545454,1.2444444444444445,0.0041936713686618375,0.009076204169662113,0.004522158577027435,0.004882532801000276,0.004554045592634679
0663106,"Rough and Ready CDP, California",0,890,"Rough and Ready CDP, California",0,499,63106,848,1,0,-1,NA,-1,0,0,0.0011792452830188679,0,-0.0011792452830188679
0663134,"Round Mountain CDP, California",0,119,"Round Mountain CDP, California",0,89,63134,140,0,0,0,NA,NA,0,0,0,0,0
0663148,"Round Valley CDP, California",0,292,"Round Valley CDP, California",26,509,63148,654,40,26,-14,NA,-0.35,0,0.05108055009823183,0.06116207951070336,0.05108055009823183,-0.010081529412471535
0663168,"Rouse CDP, California",37,1931,"Rouse CDP, California",99,2031,63168,1860,65,62,34,1.6756756756756757,0.5230769230769231,0.019161056447436563,0.04874446085672083,0.03494623655913978,0.029583404409284267,0.013798224297581048
0663218,"Rowland Heights CDP, California",610,51566,"Rowland Heights CDP, California",702,50347,63218,43790,2243,92,-1541,0.15081967213114755,-0.6870263040570664,0.011829500058177869,0.01394323395634298,0.051221740123315825,0.0021137338981651113,-0.03727850616697284
0663260,"Rubidoux CDP, California",2131,37262,NA,NA,NA,63260,24597,2368,NA,NA,NA,NA,0.05718963018624872,NA,0.09627190307761109,NA,NA
0663316,"Running Springs CDP, California",108,5068,"Running Springs CDP, California",134,4071,63316,4195,18,26,116,0.24074074074074073,6.444444444444445,0.021310181531176007,0.03291574551707197,0.004290822407628129,0.011605563985895965,0.028624923109443843
0663386,"Ruth CDP, California",0,151,"Ruth CDP, California",0,170,63386,251,0,0,0,NA,NA,0,0,0,0,0
